EmpID,Name,Gender,Date_of_Birth,Age,GROSS,Net_Pay,Deduction,Designation,Department
20438,Deana Lucero,F,2/11/96,23,35140,32559,2581,Technical Solutions Engineer.Associate.,AmaTec - APJ TSE
21921,Delbert Krause,M,24/06/1993,27,34416,30743,3673,Systems Engineer.Associate.,Product - Custom
23036,Rueben Zuniga,M,6/5/94,26,35586,33519,2067,Media Operations Engineer.Associate.,AmaTEC - BOCC/ESG
23032,Howard Pittman,M,11/2/97,23,35238,33289,1949,Media Operations Engineer.Associate.,AmaTEC - BOCC/ESG
23033,Stacie Ellis,F,7/8/95,24,35000,33071,1929,Media Operations Engineer.Associate.,AmaTEC - BOCC/ESG
18466,Leopoldo Jordan,M,11/1/91,29,35058,31777,3281,Account Service Manager..,EMEA - AMG
19836,Jean Hammond,M,5/2/92,28,38373,36029,2344,Product Operations Analyst..,IT Product Management & Ops
22437,Eliza Valenzuela,F,12/12/97,22,35976,33932,2044,Q/A Engineer..,IT DevOps
22531,Gabriel Winters,M,29/10/1997,22,35521,33717,1804,Q/A Engineer..,IT DevOps
19203,Martha Smith,F,5/12/93,26,35834,33089,2745,Software Development Engineer in Test..,Dynamic Media SQA
18918,Etta Maldonado,F,11/8/92,27,37911,35800,2111,Client Service Manager.Associate.,Americas- AMG
17061,Rosanna Glenn,F,27/05/1994,26,39028,36807,2221,Client Service Manager.Associate.,APJ - AMG
18656,Danielle Estrada,F,30/08/1992,27,37459,35797,1662,Account Service Manager..,Americas- AMG
17060,Freddy Stuart,M,21/02/1992,28,36616,34925,1691,Server Tech Services Engineer..,Networks - APJ Infrastructure
22361,Trina Solis,F,28/08/1989,30,37361,34050,3311,Account Service Manager..,APJ - AMG
21714,Jame Haas,M,10/5/89,31,36965,34131,2834,Help Desk Specialist.Associate.,Enterprise Infrastructure Services
22432,Verna Richmond,F,27/11/1994,25,37730,31340,6390,Finance Systems Analyst.Associate.,Corporate Systems
21468,Thaddeus Reed,M,20/02/1997,23,39733,33448,6285,Software Development Engineer in Test..,IT DevOps
22140,Edmond Bowman,M,29/11/1997,22,37459,33775,3684,Software Development Engineer in Test..,Media Ghost
21362,Debra Calhoun,F,19/07/1997,22,40166,36736,3430,Software Development Engineer in Test..,Media Experience SQA
10514,Sylvia Moss,F,7/7/88,32,40074,37560,2514,Travel and Vendor Management Specialist..,Global Procurement
22790,Sasha Hammond,F,2/4/95,25,37477,34758,2719,Account Service Manager..,EMEA - AMG
22307,Freda Chapman,F,3/9/94,25,40430,38010,2420,Security Operations Technician..,APJ Security Services - SOCC
18653,Lindsay Trevino,F,25/02/1994,26,39959,36096,3863,Client Service Manager.Associate.,Americas- AMG
22292,Clyde Strong,M,1/3/94,26,39696,37351,2345,Contract/Billing Analyst.Associate.,Finance - Customer Revenue Operations G&A
18833,Art Serrano,M,17/04/1993,27,39897,35527,4370,Account Service Manager..,APJ - AMG
18661,Benjamin James,M,17/02/1991,29,38915,34330,4585,Account Service Manager..,Americas- AMG
19771,Oswaldo Landry,M,30/12/1995,24,37572,29661,7911,Software Development Engineer in Test..,Dynamic Media SQA
19964,Claudio Rowland,M,17/04/1995,25,39642,34996,4646,Software Development Engineer in Test..,Dynamic Media SQA
22298,Asa Mcdowell,M,2/3/95,25,38327,36718,1609,Contract/Billing Analyst.Associate.,Finance - Customer Revenue Operations G&A
18616,Melody Munoz,F,14/10/1994,25,39599,37432,2167,Product Operations Analyst..,Web Strategy
19759,Gerald Gross,M,18/04/1996,24,41340,36394,4946,Software Development Engineer in Test..,Dynamic Media SQA
20452,Zachery Zavala,M,13/05/1996,24,38116,34568,3548,Media Operations Engineer.Associate.,Amatec - BOCC/EMM
22686,Morgan Owens,M,14/05/1994,26,38562,36739,1823,Account Service Manager..,Americas- AMG
23039,Byron Brady,M,1/12/93,26,40216,38182,2034,Technical Solutions Engineer..,AmaTec - APJ TSE
20320,Armand Meadows,M,18/01/1991,29,42656,38583,4073,Account Service Manager..,Americas- AMG
20455,Deann Cabrera,F,9/4/96,24,40038,36405,3633,Software Development Engineer in Test..,Developer Productivity
22730,Fanny Reed,F,15/02/1996,24,41670,39024,2646,Server Tech Services Engineer..,Networks - EMEA Infrastructure
22606,Marlin Kramer,M,12/8/94,25,41809,38956,2853,Server Tech Services Engineer..,Networks - EMEA Infrastructure
17490,Domingo Swanson,M,10/8/89,30,40782,36427,4355,Client Service Manager.Associate.,EMEA - AMG
18224,Mathew Hinton,M,10/11/89,30,40378,38563,1815,Account Service Manager..,Americas- AMG
22151,Wilburn Barton,M,25/11/1997,22,40744,30349,10395,Software Engineer..,Media Services Engineering
21367,Traci Middleton,F,24/01/1996,24,41768,32596,9172,Software Engineer..,LUNA/OPEN Engineering
22148,Malcom Reynolds,M,11/1/98,22,39871,30982,8889,Software Engineer..,Enterprise Applications
21383,Tobias Hurley,M,16/07/1998,21,39424,30693,8731,Software Engineer..,AmaTec - APS
21369,Tanner Norman,M,17/02/1997,23,42147,33745,8402,Software Engineer..,Enterprise Applications
21377,Cherry Gentry,F,16/10/1996,23,39765,32911,6854,Software Engineer..,Media Portal
18627,Shon Lambert,M,11/7/93,27,42612,39789,2823,Product Operations Analyst..,IT Product Management & Ops
19044,Mara Hanna,F,5/8/91,28,43451,40354,3097,Network Engagement Consultant..,Networks - EMEA Infrastructure
23062,Geoffrey Benton,M,29/11/1989,30,41408,39391,2017,Network Administrator II..,Enterprise Infrastructure Services
22138,Kirk Orr,M,13/10/1991,28,40992,37761,3231,Client Service Manager.Associate.,Americas- AMG
20762,Ezra Pugh,M,2/6/92,28,39832,38101,1731,Account Service Manager..,Americas- AMG
20447,Buford Mcguire,M,22/09/1996,23,40122,29134,10988,Software Development Engineer in Test..,Media Portal
17205,Long Krause,M,10/12/93,26,42190,38244,3946,Account Service Manager..,Americas- AMG
22620,Cora Davila,F,22/02/1994,26,43358,40234,3124,Process & Quality Engineer..,Platform Operations
20451,Elise Buchanan,F,6/2/97,23,40500,36076,4424,Technical Solutions Engineer.Associate.,AmaTec - APJ TSE
21644,Lawerence Downs,M,5/7/91,29,41847,41131,716,Business Operations Analyst..,Marketing - Operations
9276,Jerrell Coleman,M,26/07/1988,31,41450,31588,9862,Program Manager.Associate.,Marketing - Website Management
19364,Edward Newman,M,17/10/1994,25,42549,37146,5403,Software Development Engineer in Test..,Dynamic Media SQA
18103,Rosella Byrd,F,31/05/1993,27,44156,40922,3234,Logistics Specialist..,Networks - APJ Infrastructure
22009,Sherrie Leonard,F,3/3/96,24,44340,39296,5044,Q/A Engineer..,AmaTec - APS
21373,Erwin Carson,M,22/06/1997,23,43414,32059,11355,Software Engineer..,Media Analytics
21352,Evelyn Barrera,F,12/6/97,23,42761,34687,8074,Solutions Architect.Associate.,Service Delivery EMEA
22141,Jerald Hardin,M,16/08/1997,22,44201,36951,7250,Technical Solutions Engineer.Associate.,AmaTec - EMEA TSE
16768,Celia Lambert,F,3/11/93,26,42296,39315,2981,Client Service Manager..,APJ - AMG
20815,Jane Turner,F,1/4/95,25,44281,40511,3770,Media Operations Engineer.Associate.,Amatec - BOCC/EMM
21358,Logan Yu,M,20/08/1997,22,43151,33540,9611,Software Engineer..,Enterprise Applications
22149,Stanford Bean,M,5/2/98,22,42970,33542,9428,Software Engineer..,Corporate Systems
21361,Art Trujillo,M,16/01/1998,22,41814,32395,9419,Software Engineer..,Enterprise Applications
21473,Willis Beasley,M,23/04/1997,23,41622,32504,9118,Software Engineer..,App Architecture & Integration Services
21472,Bryant Bolton,M,9/6/97,23,41700,32641,9059,Software Engineer..,Corporate Systems
21374,Mark Walters,M,14/07/1997,23,43970,34961,9009,Software Engineer..,Enterprise Applications
21355,Jon Jordan,M,6/7/97,23,43848,34890,8958,Software Engineer..,Enterprise Applications
22146,Margo Dixon,F,14/03/1998,22,43603,34662,8941,Data Engineer..,Data Engineering Analytics & Intelligence
21371,Cristopher Hall,M,2/4/97,23,42623,33788,8835,Software Engineer..,IT DevOps
21370,Dewey Stephens,M,23/09/1998,21,41374,32574,8800,Software Engineer..,Enterprise Applications
21349,Simon Parker,M,17/07/1997,22,42173,33418,8755,Software Engineer..,Enterprise Applications
21354,Wilber Haney,M,6/6/97,23,43533,35202,8331,Software Engineer..,Enterprise Applications
21357,Mack Chase,M,1/7/96,24,44708,37715,6993,Software Engineer..,Media Ghost
21351,Errol Villa,M,21/08/1997,22,41250,36903,4347,Software Engineer..,AmaTec - APS
21347,Chase Hobbs,M,5/8/97,22,41180,37414,3766,Software Engineer..,GSS EPIC Engineering (HC COGS)
21356,Melba Novak,F,13/12/1997,22,44232,40683,3549,Software Engineer..,Enterprise Applications
21969,Jessie Dean,M,12/12/91,28,44639,38703,5936,Technical Solutions Engineer..,AmaTec - Americas TSE
20435,Raymond Shah,M,10/1/97,23,42742,38122,4620,Technical Solutions Engineer.Associate.,AmaTec - APJ TSE
22025,Rashad Walton,M,11/12/93,26,41406,34294,7112,Systems Engineer.Associate.,Product - Custom
19751,Jesus Delgado,M,29/09/1995,24,42873,38659,4214,Software Engineer..,Enterprise Applications
20434,Kelley Dorsey,F,3/2/96,24,42325,31831,10494,Software Development Engineer in Test..,Media Analytics
19575,Keven Norman,M,3/9/94,25,44595,42710,1885,Product Operations Analyst.Associate.,IT Product Management & Ops
16337,Lindsey Mcgee,F,21/02/1991,29,45406,42402,3004,System Operations Engineer..,Platform Operations
20458,Tina Suarez,F,15/03/1994,26,44668,40449,4219,Client Service Manager.Associate.,Americas- AMG
21713,Roosevelt Bennett,M,19/02/1993,27,45598,39948,5650,Financial Analyst..,Media Division Finance
21366,Sebastian Briggs,M,4/4/97,23,43315,35124,8191,Software Engineer..,Dynamic Media SQA
19957,Jim Berry,M,25/06/1988,32,45727,41591,4136,Contract/Billing Analyst..,Finance - Customer Revenue Operations G&A
20149,Josue Buchanan,M,22/01/1994,26,42518,31237,11281,Client Service Manager.Associate.,Americas- AMG
17267,Lucia Spencer,F,23/02/1994,26,45646,35503,10143,Software Development Engineer in Test..,Media Portal
22974,Gustavo Casey,M,29/05/1993,27,43992,41777,2215,Account Service Manager..,Americas- AMG
18094,Avery Chan,M,30/07/1997,22,42198,36003,6195,Systems Engineer..,Product - Custom
21851,Antione Vaughan,M,5/11/94,25,42348,36972,5376,Network Engagement Consultant..,Networks - EMEA Infrastructure
22032,Dion Holmes,M,2/4/93,27,45338,40422,4916,Network Engagement Consultant..,Networks - EMEA Infrastructure
14596,Beth Lyons,F,20/01/1991,29,42444,36208,6236,Billing Specialist..,Finance - Customer Revenue Operations G&A
16771,Donnell Summers,M,13/12/1981,38,44491,41188,3303,Help Desk Administrator.Senior.,Enterprise Infrastructure Services
19769,Dillon Woodard,M,17/04/1996,24,43936,32718,11218,Software Engineer..,App Architecture & Integration Services
22681,Elisha Fuller,M,3/1/98,22,44788,33693,11095,Platform Operations Engineer.Associate.,Platform Operations
21819,Ismael Jacobs,M,29/06/1992,28,43357,37824,5533,Server Tech Services Engineer..,Networks - APJ Infrastructure
19756,Tanner Bailey,M,12/1/97,23,45854,40329,5525,Software Engineer..,IT DevOps
19061,Danial Daugherty,M,10/4/89,31,45090,43060,2030,Accounts Receivable Specialist.Senior.,Finance - Customer Revenue Operations G&A
10703,Jeannine Carr,F,14/03/1990,30,44006,39284,4722,Order Analyst II..,Finance - Customer Revenue Operations G&A
21854,Marci Villegas,F,14/05/1993,27,44452,34634,9818,Q/A Engineer..,IT DevOps
22708,Jarvis Gamble,M,18/10/1992,27,46232,42469,3763,Network Administrator..,Enterprise Infrastructure Services
19770,Brant Salinas,M,30/12/1996,23,44629,31777,12852,Software Engineer..,Enterprise Applications
21038,Harriett Turner,F,3/9/92,27,45182,41749,3433,Software Development Engineer in Test..,IT DevOps
19472,Danial Mooney,M,15/04/1995,25,45169,39086,6083,Software Development Engineer in Test II..,Dynamic Media SQA
16378,Socorro Horne,F,28/03/1988,32,44549,40610,3939,Business Operations Analyst..,Global Sales Ops
19579,Kim Schneider,M,15/03/1989,31,46938,33643,13295,Systems Administrator..,Enterprise Infrastructure Services
20832,Coy Gates,M,24/11/1992,27,46560,41431,5129,Media Operations Engineer.Associate.,Amatec - BOCC/EMM
19485,Theodore Burke,M,18/12/1989,30,46438,41072,5366,Network Engagement Consultant..,Networks - APJ Infrastructure
20655,Kathrine Frost,F,31/08/1994,25,45148,39507,5641,Technical Solutions Engineer.Associate.,AmaTec - Americas TSE
19762,Jefferey Aguirre,M,5/3/96,24,44384,32890,11494,Software Engineer..,Enterprise Applications
20308,Robt Walters,M,1/10/88,31,43676,38937,4739,Collections Specialist..,Finance - Customer Revenue Operations G&A
19740,Beatriz Kirby,F,16/10/1985,34,46426,42222,4204,Payroll Analyst..,Finance - Accounting
19359,Natasha Faulkner,F,27/12/1990,29,44470,38796,5674,Order Analyst II..,Finance - Customer Revenue Operations G&A
21980,Herb Greene,M,17/08/1994,25,43801,40324,3477,Network Engagement Consultant..,Networks - EMEA Infrastructure
18393,Ashley Morales,F,14/07/1985,35,45985,41056,4929,Web Content Publisher..,Marketing - Website Management
20918,Jim Thompson,M,29/09/1992,27,44974,36018,8956,Software Development Engineer in Test..,Media Experience SQA
19503,Audrey Oneal,F,14/07/1989,31,44373,32104,12269,Booking Operations Analyst II..,Financial Planning and Analysis
19940,Monty Dixon,M,13/08/1992,27,45321,40493,4828,Software Development Engineer in Test II..,Media Analytics
12355,Priscilla Griffith,F,7/11/87,32,47191,41212,5979,Product Marketing Specialist.Associate.,Web Global Industry & Product Marketing
21684,Douglass Orozco,M,8/1/91,29,47883,42557,5326,Account Service Manager..,Americas- AMG
20953,Elvin Black,M,17/12/1995,24,45040,43512,1528,Account Service Manager.Associate.,Americas- AMG
18545,Dylan Velasquez,M,5/5/93,27,46782,46672,110,Q/A Engineer.Senior.,IT DevOps
22789,Allan Shah,M,11/12/93,26,47203,44652,2551,Platform Operations Engineer.Associate.,Platform Operations
21578,Elinor Price,F,30/03/1992,28,45086,39697,5389,Release Engineer II..,Media Delivery Product Engineering
22086,Kraig Mueller,M,25/03/1990,30,47869,45182,2687,Business Operations Analyst..,Marketing - Operations
20050,Refugio Campbell,M,29/10/1993,26,45045,39543,5502,Software Development Engineer in Test..,Storage Engineering
20069,Dina Zavala,F,11/7/91,29,44384,38414,5970,Technical Solutions Engineer..,AmaTec - APJ TSE
20443,Sasha Pitts,F,10/8/96,23,44273,39330,4943,Technical Solutions Engineer.Associate.,AmaTec - Americas TSE
18811,Stuart Vang,M,13/12/1989,30,46999,41145,5854,Collections Specialist..,Finance - Customer Revenue Operations G&A
19758,Denise Simmons,F,15/12/1995,24,45318,31345,13973,Software Development Engineer in Test..,Media Services Engineering
18465,Kelsey Parsons,F,27/11/1995,24,46770,39909,6861,Technical Solutions Engineer..,AmaTec - APJ TSE
19488,Aaron Hanna,M,11/9/91,28,47145,41699,5446,Order Analyst II..,Finance - Customer Revenue Operations G&A
19755,Harlan Atkinson,M,1/7/96,24,46610,36689,9921,Software Engineer..,Media Analytics
19459,Elwood Mercado,M,14/07/1992,28,45011,35345,9666,Systems Support Engineer..,IT DevOps
19086,Pablo Bowers,M,18/02/1994,26,45143,40119,5024,Network Engagement Consultant..,Networks - APJ Infrastructure
22294,Sybil Cordova,F,2/1/92,28,46621,44531,2090,Billing Specialist..,Finance - Customer Revenue Operations G&A
22429,Nona Spears,F,28/07/1992,27,48611,46576,2035,Contract/Billing Analyst..,Finance - Customer Revenue Operations G&A
17255,Allan Wilkins,M,7/8/94,25,48327,38185,10142,Software Development Engineer in Test..,Web Performance Engineering
18483,Elsa Salinas,F,3/5/95,25,46947,40714,6233,Technical Support Engineer..,AmaTec - Weekend TSE
20055,Avery Barber,M,27/02/1996,24,47872,45365,2507,Platform Operations Engineer.Associate.,Platform Operations
19020,Elva Andrade,F,2/9/93,26,45436,41147,4289,Server Tech Services Engineer..,Networks - APJ Infrastructure
20830,Pablo Myers,M,1/4/85,35,47190,41659,5531,Contract/Billing Analyst..,Finance - Customer Revenue Operations G&A
20769,Bethany Arellano,F,10/11/90,29,47849,33035,14814,Billing Specialist..,Finance - Customer Revenue Operations G&A
22145,Irma Barry,F,29/11/1996,23,46286,36636,9650,Media Operations Engineer.Associate.,Amatec - BOCC/EMM
20444,Colette Fowler,F,16/03/1997,23,47785,42099,5686,Technical Solutions Engineer.Associate.,AmaTec - Americas TSE
19752,Trenton Petty,M,28/11/1996,23,46218,39242,6976,Software Engineer..,Developer Productivity
17220,Albert Velazquez,M,1/1/96,24,47266,32839,14427,Software Development Engineer in Test II..,Dynamic Media SQA
11949,Franklin Goodman,M,12/3/81,39,47395,43459,3936,Contract/Billing Analyst II..,Finance - Customer Revenue Operations G&A
21359,Arturo Saunders,M,23/07/1997,22,47667,35875,11792,Performance Engineer..,Product - Custom
23031,Jillian Hampton,F,4/3/94,26,46210,43690,2520,Solutions Architect..,APJ Security Services
18585,Harley Mullins,M,27/06/1987,33,48666,44006,4660,Technical Solutions Engineer..,AmaTec - EMEA TSE
18378,Filiberto Becker,M,19/03/1994,26,50035,46810,3225,Platform Operations Engineer.Associate.,Platform Operations
21768,Leta Burnett,F,4/5/95,25,47898,42160,5738,Media Operations Engineer.Associate.,Amatec - BOCC/EMM
19760,Wilmer Salas,M,4/7/96,24,50000,43558,6442,Software Engineer..,Developer Productivity
19157,Darla West,F,22/11/1993,26,46815,43269,3546,Network Infrastructure Engineer..,Networks - APJ Infrastructure
12162,Christina Hahn,F,23/12/1987,32,47392,33872,13520,Program Manager..,Global Channel - Programs Support
10246,Guy Oconnell,M,20/04/1989,31,48627,42437,6190,Client Service Manager..,APJ - AMG
16581,Troy Bass,M,21/08/1991,28,49466,44811,4655,Billing Specialist II..,Finance - Customer Revenue Operations G&A
16338,Kelly Estes,M,8/7/94,26,49635,42704,6931,Network Infrastructure Engineer..,Networks - EMEA Infrastructure
22548,Leigh Chang,F,22/07/1994,25,49955,47170,2785,Platform Operations Engineer.Associate.,Platform Operations
20450,Sophia Cabrera,F,28/07/1994,25,50028,39039,10989,Software Development Engineer in Test..,Media Portal
16340,Emilia Dennis,F,28/10/1994,25,50527,45276,5251,Network Infrastructure Engineer..,Networks - EMEA Infrastructure
16247,Fritz Sawyer,M,21/09/1990,29,48229,34627,13602,Client Service Manager..,Americas- AMG
17734,Leif Pitts,M,7/9/90,29,50129,45272,4857,Billing Specialist II..,Finance - Customer Revenue Operations G&A
16353,Marguerite Pitts,F,10/4/94,26,49577,41277,8300,Software Engineer..,Networks - Productivity - Systems
19426,Kristofer Lambert,M,25/09/1990,29,47698,42427,5271,Client Service Manager..,APJ - AMG
22030,Warren Camacho,M,10/3/95,25,47523,39394,8129,Platform Operations Engineer.Associate.,Platform Operations
21818,Jill Oneill,F,31/10/1994,25,47680,38362,9318,Solutions Architect.Associate.,Service Delivery Americas Web
15117,Erich Gaines,M,25/04/1989,31,48295,33865,14430,Software Engineer..,GSS EPIC Engineering (HC COGS)
19008,Lucius Underwood,M,31/01/1991,29,50467,44030,6437,Order Analyst II..,Finance - Customer Revenue Operations G&A
16289,Cheri Miranda,F,3/5/90,30,46953,37658,9295,Network Implementation Manager..,Networks - APJ Infrastructure
22637,Angel Powell,F,22/11/1993,26,50782,47586,3196,Media Operations Engineer.Associate.,Amatec - BOCC/EMM
20054,Aida Rocha,F,27/03/1995,25,47215,44015,3200,Platform Operations Engineer.Associate.,Platform Operations
22139,Margret Brewer,F,5/10/93,26,51047,41309,9738,Software Engineer..,Enterprise Applications
22434,Gabrielle Moore,F,23/01/1995,25,50753,47363,3390,System Operations Engineer..,Platform Operations
19767,Luis Baxter,M,11/5/96,24,51156,36985,14171,Software Engineer..,Media Portal
19560,Ashlee Rose,F,31/01/1992,28,50222,42267,7955,Q/A Engineer II..,IT DevOps
14681,Jeanne Waters,F,17/05/1993,27,47817,41106,6711,Order Analyst II..,Finance - Customer Revenue Operations G&A
17733,Lon Price,M,30/10/1987,32,50413,31806,18607,Contract/Billing Analyst..,Finance - Customer Revenue Operations G&A
20491,Robert Reynolds,M,21/04/1990,30,49841,44903,4938,Network Implementation Manager..,Networks - APJ Infrastructure
17425,Arthur Conner,M,6/12/92,27,49538,44428,5110,Booking Operations Analyst II..,Financial Planning and Analysis
20453,Augusta Crane,F,25/12/1996,23,51123,40166,10957,Technical Solutions Engineer.Associate.,AmaTec - APJ TSE
18473,Laurie Morales,F,3/5/96,24,49054,30071,18983,Software Engineer..,Media Analytics
19041,Keneth Quinn,M,15/05/1990,30,49766,41106,8660,Technical Solutions Engineer..,AmaTec - Americas TSE
18640,Valentin West,M,2/12/93,26,49861,42984,6877,Media Operations Engineer..,AmaTec - BOCC
17882,Essie Reese,F,13/08/1994,25,49119,43827,5292,Technical Solutions Engineer.Associate.,AmaTec - Weekend TSE
20148,Darla Munoz,F,17/06/1990,30,48000,42615,5385,Order Analyst..,Finance - Customer Revenue Operations G&A
17672,Mable Coffey,F,4/1/95,25,51321,46282,5039,Technical Solutions Engineer..,AmaTec - EMEA TSE
20849,Fredric Peters,M,29/04/1988,32,47809,31336,16473,LMS Administrator II..,Learning & Development
19559,Francesco Orr,M,25/03/1991,29,50010,43776,6234,Systems Support Engineer II..,IT DevOps
14254,Justine Whitney,F,20/07/1988,31,51098,46197,4901,Order Analyst II..,Finance - Customer Revenue Operations G&A
19887,Olivia Mccoy,F,21/05/1991,29,50298,45293,5005,Client Service Manager..,EMEA - AMG
9040,Carlene Gordon,F,7/11/89,30,48399,42912,5487,Collections Specialist II..,Finance - Customer Revenue Operations G&A
20130,Fredrick Bruce,M,4/12/86,33,48162,42958,5204,Client Service Manager..,EMEA - AMG
17225,Johnathon Day,M,2/12/94,25,51601,38163,13438,Software Development Engineer in Test II..,Media Analytics
22907,Dianne Williams,F,1/6/93,27,49512,46459,3053,Platform Operations Engineer..,Platform Operations
22453,Neville Wright,M,4/10/95,24,48962,45530,3432,Software Engineer..,AmaTec - APS
21876,Leticia Kim,F,5/7/90,30,50825,45758,5067,Software Engineer..,Enterprise Applications
20604,Rose Serrano,F,8/6/91,29,51618,46867,4751,Media Operations Engineer..,Amatec - BOCC/EMM
17937,Georgia Mccarty,F,15/04/1992,28,49597,44481,5116,Q/A Engineer II..,IT DevOps
22619,Liza Poole,F,13/03/1998,22,50904,47564,3340,Technical Solutions Engineer.Associate.,AmaTec - EMEA TSE
20726,Manual Barron,M,24/03/1991,29,51723,37416,14307,Contract/Billing Analyst..,Finance - Customer Revenue Operations G&A
10990,Harry Schneider,M,5/3/86,34,49052,41682,7370,Help Desk Specialist..,Enterprise Infrastructure Services
21848,Ivory Mitchell,M,24/11/1993,26,49019,42891,6128,Technical Solutions Engineer.Associate.,AmaTec - EMEA TSE
22154,Natalie Macias,F,16/01/1993,27,48560,44073,4487,Client Service Manager..,Americas- AMG
18835,Darius Wilkerson,M,14/01/1991,29,50753,50643,110,Technical Solutions Engineer..,AmaTec - EMEA TSE
17736,Hilda English,F,10/9/93,26,49952,42889,7063,Technical Solutions Engineer.Associate.,AmaTec - Americas TSE
17357,Doris Bond,F,17/12/1988,31,50038,45076,4962,Business Operations Analyst..,Global Sales Ops
21781,Lucius Terry,M,13/01/1992,28,50160,39867,10293,Contract/Billing Analyst..,Finance - Customer Revenue Operations G&A
20442,Russel Weeks,M,10/7/96,24,51960,40995,10965,Technical Solutions Engineer.Associate.,AmaTec - Americas TSE
20448,Mara Chaney,F,21/07/1996,23,50356,44736,5620,Technical Solutions Engineer.Associate.,AmaTec - APJ TSE
20652,Oren Frank,M,25/07/1990,29,52256,44178,8078,Contract/Billing Analyst..,Finance - Customer Revenue Operations G&A
18480,Freddie Friedman,M,1/1/96,24,52676,38489,14187,Software Engineer..,Media Portal
19852,Sallie Gomez,F,25/03/1990,30,51491,46350,5141,Client Service Manager..,Americas- AMG
18247,Keenan Estes,M,1/4/95,25,50153,43866,6287,Technical Solutions Engineer..,AmaTec - Americas TSE
19663,Rosemary Turner,F,23/03/1996,24,49631,41087,8544,Software Development Engineer in Test II..,Media Experience SQA
12022,Mathew Blackwell,M,1/12/87,32,52769,45238,7531,Order Analyst II..,Finance - Customer Revenue Operations G&A
18149,Joan Owen,F,6/3/93,27,51642,45940,5702,Technical Solutions Engineer..,AmaTec - EMEA TSE
19136,Candy Goodwin,F,18/10/1993,26,51862,45255,6607,Software Development Engineer in Test..,Media Portal
22380,Marcus Shields,M,17/04/1993,27,51147,47376,3771,Q/A Engineer II..,IT DevOps
16305,Archie Carey,M,16/12/1992,27,49627,35449,14178,Technical Solutions Engineer..,AmaTec - Americas TSE
12056,Nicky Day,M,2/12/89,30,49634,38503,11131,Business Operations Analyst II..,IT Business Process Improvement & Change Mgmt
20175,Keenan Cherry,M,8/4/94,26,50937,35771,15166,Software Development Engineer in Test..,Media Experience SQA
22218,Refugio Thompson,M,23/06/1992,28,52960,50017,2943,Network Infrastructure Engineer..,Networks - EMEA Infrastructure
14352,Delmer Rollins,M,10/7/90,30,51804,49193,2611,Security Operations Technician II..,APJ Security Services - SOCC
20051,Shelton Blackburn,M,27/08/1991,28,51412,39249,12163,Sales Development Representative..,APJ Sales Development
19888,Ellis Cook,M,10/10/94,25,51449,41119,10330,Security Operations Technician II..,APJ Security Services - SOCC
20189,Kim Stafford,M,7/11/89,30,51207,44771,6436,Client Service Manager..,EMEA - AMG
20690,Edwardo Benjamin,M,13/12/1994,25,52351,45434,6917,Media Operations Engineer.Associate.,Amatec - BOCC/EMM
20476,Karla Hopkins,F,12/6/93,27,51819,36610,15209,Software Development Engineer in Test II..,Media Services Engineering
6406,Denis Whitney,M,21/07/1982,37,52417,46821,5596,Revenue Accountant..,Finance - Accounting
21665,Gerardo Rodriguez,M,19/05/1996,24,50903,48277,2626,Technical Solutions Engineer.Associate.,AmaTec - EMEA TSE
16487,Selena Shaw,F,5/6/92,28,52454,45191,7263,Server Tech Services Engineer II..,Networks - APJ Infrastructure
17670,Stewart Schroeder,M,11/6/90,30,52812,47178,5634,Technical Solutions Engineer..,AmaTec - Americas TSE
7002,Dusty Brooks,M,3/1/81,39,53330,48948,4382,Logistics Specialist.Senior.,Networks - EMEA Infrastructure
10516,Fritz Andrade,M,24/01/1990,30,51510,44469,7041,Graphic Designer II..,Learning & Development
15387,Casandra Cochran,F,21/01/1992,28,50115,38702,11413,Release Engineer II..,IT DevOps
10249,Domenic Cox,M,1/3/88,32,52241,45247,6994,Help Desk Specialist..,Enterprise Infrastructure Services
23001,Marisol Hood,F,16/10/1996,23,53126,50086,3040,Contract/Billing Analyst..,Finance - Customer Revenue Operations G&A
19642,Isiah Mckenzie,M,20/12/1989,30,51123,43827,7296,Client Service Manager..,Americas- AMG
14776,Mike Hardy,M,3/3/93,27,54350,51659,2691,Platform Operations Engineer..,Platform Operations
17638,Son Mendoza,M,26/09/1989,30,53716,46183,7533,Security Operations Technician II..,APJ Security Services - SOCC
16352,Annmarie Ortega,F,24/07/1992,27,54322,36920,17402,Platform Operations Engineer..,Platform Operations
21773,Aline Kirk,F,13/01/1994,26,54134,49045,5089,Technical Solutions Engineer..,AmaTec - APJ TSE
20384,Judson Li,M,25/02/1990,30,52498,46057,6441,Billing Specialist..,Finance - Customer Revenue Operations G&A
22269,Brooke Joyce,F,13/10/1995,24,51733,48589,3144,Software Engineer..,AmaTec - APS
22289,Rhea Bennett,F,3/10/92,27,54299,42661,11638,Software Engineer..,Media Services Engineering
22365,Claudia Curtis,F,12/10/92,27,50962,40605,10357,Release Engineer II..,IT DevOps
22849,Carmela Hatfield,F,26/11/1993,26,54059,41747,12312,Technical Solutions Engineer..,AmaTec - Americas TSE
20259,Waylon Hester,M,18/03/1994,26,51798,39875,11923,Software Development Engineer in Test II..,Dynamic Media SQA
16335,Melba Roberts,F,19/09/1993,26,53773,47169,6604,Network Infrastructure Engineer..,Networks - EMEA Infrastructure
22308,Kayla Rowland,F,26/04/1994,26,51275,45065,6210,Network Infrastructure Engineer..,Networks - EMEA Infrastructure
12370,Madeline Dixon,F,27/07/1991,28,54324,47404,6920,Contract/Billing Analyst II..,Finance - Customer Revenue Operations G&A
16400,Seth Morton,M,25/01/1994,26,54658,46079,8579,Network Infrastructure Engineer..,Networks - APJ Infrastructure
18547,Tanner Holder,M,12/9/94,25,52542,43721,8821,Technical Solutions Engineer..,AmaTec - EMEA TSE
18203,Kristy Mccall,F,24/02/1994,26,53366,42582,10784,Technical Solutions Engineer..,AmaTec - Weekend TSE
14653,Oliver Vaughn,M,2/8/87,32,53870,40718,13152,Q/A Engineer II..,GSS EPIC Engineering (HC COGS)
16866,Roosevelt Neal,M,6/12/94,25,51744,45181,6563,Technical Solutions Engineer..,AmaTec - Weekend TSE
16557,Sherwood Clarke,M,16/06/1990,30,52566,45057,7509,Site Reliability Engineer..,LUNA/OPEN Engineering
19122,Garth Ali,M,13/05/1990,30,53157,41439,11718,Collections Specialist II..,Finance - Customer Revenue Operations G&A
16787,Rolf Wilson,M,28/05/1987,33,50999,48599,2400,Platform Operations Engineer.Associate.,Platform Operations
21779,Vanessa Andersen,F,10/8/94,25,53073,37489,15584,Technical Solutions Engineer.Associate.,AmaTec - EMEA TSE
22284,Elijah Grimes,M,25/05/1995,25,52619,50338,2281,Technical Solutions Engineer.Associate.,AmaTec - Americas TSE
22430,Man Sheppard,M,2/6/96,24,54858,51488,3370,Technical Solutions Engineer.Associate.,AmaTec - Americas TSE
19918,Emory Houston,M,24/02/1994,26,52185,45632,6553,Technical Solutions Engineer..,AmaTec - EMEA TSE
19173,Noelle Blair,F,29/06/1992,28,52128,42083,10045,Platform Operations Engineer.Associate.,Platform Operations
16019,Brian Nguyen,M,22/12/1989,30,51632,39458,12174,Systems Support Engineer II..,IT DevOps
22248,Adrian Villanueva,F,17/03/1990,30,53796,51556,2240,Billing Specialist..,Finance - Customer Revenue Operations G&A
20646,Natasha Ford,F,14/01/1993,27,51920,45309,6611,Software Development Engineer in Test..,Platform Mapping Engineering
21647,Judson Mckay,M,25/05/1990,30,53607,45490,8117,Network Administrator..,Enterprise Infrastructure Services
21495,Aurelia Phillips,F,29/06/1991,29,54763,47981,6782,Collections Specialist..,Finance - Customer Revenue Operations G&A
19798,Lacy Lara,M,24/03/1997,23,54469,38031,16438,Software Engineer..,Media Services Engineering
18206,Roscoe Moore,M,15/02/1994,26,53332,42177,11155,Technical Solutions Engineer..,AmaTec - APJ TSE
21880,Roman Logan,M,6/3/94,26,54043,47728,6315,Release Engineer II..,IT DevOps
20579,Joyce Aguilar,F,24/06/1991,29,54999,49722,5277,Client Service Manager..,Americas- AMG
22793,Lon Howe,M,22/08/1991,28,52754,48961,3793,Platform Operations Engineer..,Platform Operations
22016,Victoria Werner,F,23/05/1993,27,52983,46634,6349,Sales Development Representative..,APJ Sales Development
19764,Kristofer Allen,M,18/08/1996,23,52108,44365,7743,Solutions Architect..,APJ Security Services
17936,Edwardo Cochran,M,17/04/1989,31,54805,48800,6005,Business Operations Analyst II..,Marketing - Operations
21418,Lazaro Vazquez,M,18/03/1992,28,52038,40515,11523,Technical Solutions Engineer..,AmaTec - Americas TSE
22204,Odis Meadows,M,7/7/93,27,55535,47782,7753,Client Service Manager..,Americas- AMG
17358,Ahmed Bates,M,11/4/92,28,55190,48916,6274,Booking Operations Analyst II..,Financial Planning and Analysis
17693,Leon Kramer,M,25/07/1991,28,54134,43551,10583,Q/A Engineer II..,IT DevOps
11876,Sadie Lin,F,9/7/90,30,55015,46700,8315,Network Infrastructure Engineer..,Networks - EMEA Infrastructure
19063,Leah Haynes,F,29/03/1984,36,53210,45839,7371,Client Service Manager..,APJ - AMG
9159,Kristopher Stafford,M,5/5/86,34,54014,38738,15276,Graphic Designer II..,Learning & Development
22272,Anthony Simon,M,22/09/1993,26,55289,51248,4041,User Interface Engineer..,AmaTec - APS
22445,Holly Perry,F,16/09/1995,24,53425,50085,3340,Software Engineer..,AmaTec - APS
16330,Timmy Mcdonald,M,25/03/1992,28,56013,44745,11268,Network Infrastructure Engineer..,Networks - EMEA Infrastructure
17931,Concetta Brady,F,23/11/1988,31,55093,37271,17822,Client Service Manager..,Americas- AMG
19627,Abigail Frederick,F,24/01/1991,29,55087,48525,6562,Partner Services Manager..,Americas- AMG
22720,Lea Mccormick,F,27/08/1988,31,54487,51847,2640,Client Service Manager..,Americas- AMG
18654,Lindsay Anthony,F,2/11/93,26,55351,48830,6521,Media Operations Engineer..,AmaTec - BOCC
16214,Jimmie Robertson,F,22/05/1990,30,53927,46433,7494,Contract/Billing Analyst II..,Finance - Customer Revenue Operations G&A
18768,Manual Fleming,M,12/10/92,27,53597,45787,7810,Technical Solutions Engineer..,AmaTec - Americas TSE
21437,Bobby Horton,M,13/11/1995,24,55504,52718,2786,Technical Solutions Engineer.Associate.,AmaTec - Weekend TSE
22187,Freddie Curry,M,16/06/1993,27,54973,50424,4549,Platform Operations Engineer..,Platform Operations
22808,Reid Gonzales,M,23/07/1991,28,53030,49222,3808,Platform Operations Engineer..,Platform Operations
20446,Stan Pratt,M,1/6/95,25,56402,48864,7538,Technical Solutions Engineer.Associate.,AmaTec - Americas TSE
18813,Russell Hughes,M,19/03/1989,31,56556,36471,20085,Software Development Engineer in Test.Senior.,IT DevOps
17667,Belinda Moran,F,22/05/1995,25,53283,45466,7817,Technical Solutions Engineer..,AmaTec - Americas TSE
22115,Colette Mahoney,F,4/11/93,26,55953,48997,6956,Network Infrastructure Engineer..,Networks - APJ Infrastructure
22362,Cortez Pennington,M,24/04/1993,27,53911,50297,3614,Network Infrastructure Engineer..,Networks - APJ Infrastructure
22607,Helga Burch,F,2/6/90,30,55716,49082,6634,Solutions Architect..,GSS EPIC Product Evaluation
19816,Ben Lopez,M,1/4/91,29,55368,41622,13746,Software Development Engineer in Test II..,Media Experience SQA
16164,Lorenzo Callahan,M,18/11/1991,28,54965,39672,15293,Systems Support Engineer II..,IT DevOps
18477,Faith Krause,F,30/06/1995,25,54682,48015,6667,Technical Solutions Engineer..,AmaTec - Americas TSE
11099,Abdul Becker,M,25/07/1985,34,55929,47907,8022,Client Service Manager..,Americas- AMG
20816,Nannie Wu,F,3/7/91,29,54057,38675,15382,Data Engineer..,Data Engineering Analytics & Intelligence
14638,Tyrell Oneill,M,15/06/1988,32,55798,53058,2740,Client Service Manager.Senior.,EMEA - AMG
18882,Wilbur Bond,M,20/02/1989,31,55560,47918,7642,Network Implementation Manager..,Networks - EMEA Infrastructure
18886,Tessa Stone,F,8/7/91,29,55164,49485,5679,Network Implementation Manager..,Networks - EMEA Infrastructure
16119,Anibal Pham,M,20/08/1991,28,54952,43218,11734,Security Analyst.Senior.,Enterprise Architecture and Security
20402,Robyn Marks,F,24/11/1992,27,55090,39950,15140,Software Development Engineer in Test II..,Media Experience SQA
15953,Tracey Holden,M,12/4/92,28,53505,37982,15523,Software Engineer II..,Enterprise Applications
17019,Rick Cortez,M,22/07/1987,32,53694,46890,6804,Client Service Manager..,Americas- AMG
20686,Stanley Newton,M,14/03/1995,25,57255,49410,7845,Media Operations Engineer.Associate.,Amatec - BOCC/EMM
15730,Willa Combs,F,25/05/1994,26,54915,46524,8391,Software Engineer II..,Enterprise Applications
15218,Nellie Shah,F,16/08/1993,26,57259,48338,8921,Software Development Engineer in Test II..,Dynamic Media SQA
19440,Edward Bradley,M,27/07/1989,30,56232,44373,11859,Client Service Manager..,Americas- AMG
8884,Annie Norris,F,14/08/1983,36,56951,45334,11617,Logistics Specialist.Senior.,Networks - EMEA Infrastructure
22114,Genaro Wells,M,29/05/1993,27,54597,47118,7479,Software Development Engineer in Test II..,LUNA/OPEN Engineering
9322,Georgia Herrera,F,28/03/1987,33,53945,38542,15403,Program Manager..,Global Channel - Programs Support
20351,Antoinette Mcguire,F,9/8/90,29,53780,40193,13587,Collections Specialist..,Finance - Customer Revenue Operations G&A
16328,Garrett Doyle,M,31/12/1992,27,56715,52528,4187,Network Infrastructure Engineer..,Networks - APJ Infrastructure
21809,Abe George,M,29/12/1994,25,57441,50785,6656,Platform Operations Engineer..,Platform Operations
6473,Gabriel Foley,M,4/6/87,33,57195,49763,7432,Human Resources Specialist II..,International - HR Operations
22117,Kimberley Padilla,F,8/11/96,23,54929,48710,6219,Technical Solutions Engineer.Associate.,AmaTec - Americas TSE
11877,Jesus Vance,M,17/03/1990,30,56568,47123,9445,Software Engineer..,Networks - Productivity - Systems
15691,Fausto Crawford,M,11/11/93,26,56954,46633,10321,Software Development Engineer in Test II..,Media Ghost
22612,Ola Lara,F,1/11/92,27,53793,47742,6051,Technical Solutions Engineer..,AmaTec - EMEA TSE
21494,Broderick Bailey,M,1/1/89,31,54594,38740,15854,Security Operations Technician II..,APJ Security Services - SOCC
7910,Lilian Soto,F,5/10/88,31,55226,39143,16083,Contract/Billing Analyst.Senior.,Finance - Customer Revenue Operations G&A
17241,Kenton Richards,M,1/12/92,27,56422,51067,5355,Platform Operations Engineer..,Platform Operations
20814,Ricardo Zimmerman,M,21/10/1991,28,54250,45340,8910,Media Operations Engineer..,Amatec - BOCC/EMM
16312,Jackson Chapman,M,24/02/1986,34,57019,43796,13223,Booking Operations Analyst II..,Financial Planning and Analysis
17040,Lauren Ponce,M,10/10/93,26,54491,38196,16295,Software Development Engineer in Test II..,Dynamic Media SQA
16841,Thelma Beard,F,18/06/1984,36,54173,39345,14828,Business Operations Analyst II..,Global Sales Ops
22176,Cameron Cross,M,29/10/1994,25,54760,46806,7954,Software Engineer..,LUNA/OPEN Engineering
21903,Frieda Delgado,F,24/06/1995,25,56116,46500,9616,Business Systems Analyst..,Enterprise Applications
16252,Lenard Owen,M,27/10/1990,29,54894,39529,15365,Client Service Manager.Senior.,APJ - AMG
22274,Cecile Ferrell,F,5/6/90,30,57060,49110,7950,Client Service Manager..,Americas- AMG
17223,Ulysses Haas,M,19/12/1995,24,57614,43514,14100,Software Engineer II..,Enterprise Applications
18776,Devon Haley,M,4/12/84,35,54652,49965,4687,Client Service Manager..,EMEA - AMG
20573,Danilo Burton,M,16/10/1992,27,57243,50945,6298,Media Operations Engineer..,Amatec - BOCC/EMM
21584,Adolfo Riley,M,28/04/1991,29,54473,47479,6994,Client Service Manager..,Americas- AMG
21372,Domenic Ross,M,1/12/96,23,57628,42327,15301,Security Operations Center Specialist..,APJ Security Services - SOCC
14351,Luis Hester,M,20/10/1989,30,58246,41771,16475,Software Development Engineer in Test II..,Dynamic Media SQA
17939,Ervin Maddox,M,19/06/1993,27,55237,47544,7693,Security Operations Technician.Senior.,APJ Security Services - SOCC
22621,Drew Rush,M,20/11/1991,28,57339,53909,3430,Solutions Architect..,Service Delivery APJ
16074,Vern Cruz,M,11/12/88,31,57729,46723,11006,Software Development Engineer in Test II..,Media Experience SQA
19763,Zack Moses,M,7/10/96,23,56283,38494,17789,Software Engineer II..,IT DevOps
18464,Barton Estrada,M,25/06/1990,30,56684,47744,8940,Business Operations Analyst..,Finance - Customer Revenue Operations S&M
11686,Alfredo Reese,M,8/4/84,36,58248,39552,18696,Billing Specialist.Senior.,Finance - Customer Revenue Operations G&A
17224,Kerry Hunter,M,2/2/95,25,55572,46748,8824,Software Engineer II..,IT DevOps
17928,Elroy Ware,M,1/8/94,25,57809,51000,6809,Platform Operations Engineer.Associate.,Platform Operations
15857,Marietta Odom,F,16/04/1990,30,58320,45084,13236,Contract/Billing Analyst II..,Finance - Customer Revenue Operations G&A
22792,Richie Branch,M,18/09/1990,29,55946,52090,3856,Platform Operations Engineer..,Platform Operations
20333,Carl Finley,M,15/01/1993,27,56259,40723,15536,Technical Solutions Engineer.Associate.,AmaTec - Americas TSE
19757,Maureen Beard,F,16/08/1995,24,57712,46081,11631,Software Engineer..,Media Services Engineering
22564,Serena Dawson,F,20/03/1995,25,55549,51759,3790,Technical Solutions Engineer..,AmaTec - Americas TSE
19471,Fern Middleton,F,3/3/86,34,55784,46523,9261,Learning & Development Specialist II..,International - Learning & Dev
18105,Lawanda Shelton,F,3/8/80,39,56383,40701,15682,Client Service Manager..,APJ - AMG
16228,Ruthie Roach,F,26/11/1985,34,55119,47713,7406,Client Service Manager.Senior.,Americas- AMG
15742,Graig Dodson,M,17/08/1991,28,57930,48946,8984,Solutions Architect..,Service Delivery EMEA
19365,Elaine Moyer,F,18/01/1992,28,56752,46971,9781,Technical Solutions Engineer..,AmaTec - CIAM
8690,Millard Werner,M,29/10/1986,33,57299,48885,8414,Business Operations Analyst..,Finance - Customer Revenue Operations G&A
20693,Ophelia Humphrey,F,10/1/96,24,57028,47430,9598,Media Operations Engineer.Associate.,Amatec - BOCC/EMM
22573,Olive Monroe,F,13/05/1992,28,56984,54198,2786,Client Service Manager..,Americas- AMG
8849,Terry Chung,M,9/3/88,32,58814,36939,21875,Human Resources Specialist II..,International - HR Operations
22195,Miles Huffman,M,9/12/89,30,56088,50545,5543,Client Service Manager..,Americas- AMG
22310,Lionel Noble,M,8/6/95,25,58828,51732,7096,Systems Engineer..,GSS EPIC Engineering (HC COGS)
18631,Erik Ramirez,M,21/11/1988,31,58619,48380,10239,Software Development Engineer in Test II..,DPM Engineering
19768,Deangelo Chen,M,27/02/1996,24,59288,43109,16179,Software Engineer..,Media Services Engineering
15346,Dexter Rasmussen,M,16/09/1990,29,58357,51661,6696,Client Service Manager.Senior.,Americas- AMG
20383,Tim Lambert,M,17/11/1994,25,58279,48888,9391,Media Operations Engineer..,Amatec - BOCC/EMM
18780,Alexander Nolan,M,22/04/1988,32,57652,41346,16306,Booking Operations Analyst II..,Financial Planning and Analysis
17208,Esther Patton,F,8/5/91,29,56926,41231,15695,Security Operations Technician.Senior.,APJ Security Services - SOCC
5676,Yvonne Rose,F,11/5/84,36,56398,48839,7559,Marketing Automation Specialist.Senior.,Marketing - Operations
21441,Rachelle Flowers,F,25/12/1991,28,57314,51175,6139,Q/A Engineer II..,AmaTec - APS
14255,Horace Wilkinson,M,27/05/1992,28,57645,40457,17188,Order Analyst.Senior.,Finance - Customer Revenue Operations G&A
22163,Leroy Gaines,M,21/12/1997,22,56883,54516,2367,Platform Operations Engineer.Associate.,Platform Operations
14350,Latisha Cook,F,21/05/1990,30,58601,41867,16734,Security Operations Technician.Senior.,APJ Security Services - SOCC
16246,Toney Galvan,M,19/11/1992,27,59564,52371,7193,Technical Solutions Engineer..,AmaTec - Americas TSE
16336,Johnson Torres,M,30/08/1994,25,57625,42742,14883,Software Engineer II..,Enterprise Applications
9205,Emory Whitney,M,27/12/1992,27,57482,49929,7553,Client Service Manager.Senior.,Americas- AMG
9915,Elva Hull,F,9/12/87,32,57099,51252,5847,Recruiter II..,Talent Acquisition
11874,Lourdes Valenzuela,F,3/6/94,26,56529,40135,16394,Software Development Engineer in Test II..,Enterprise Networks
18280,Elton Odom,M,3/3/94,26,57859,50941,6918,Technical Solutions Engineer.Associate.,AmaTec - Americas TSE
17636,Saundra Hester,F,9/3/92,28,57674,49988,7686,Q/A Engineer II..,IT DevOps
9999,Mari Holder,F,11/5/88,32,59289,52099,7190,Accountant II..,Finance - Accounting
18799,Maxwell Wilcox,M,13/11/1983,36,59558,52558,7000,Client Service Manager..,EMEA - AMG
18301,Edwina Solis,F,11/2/91,29,56175,40354,15821,Systems Support Engineer II..,LUNA/OPEN Engineering
22290,Jolene Blackwell,F,24/08/1993,26,59038,46639,12399,Release Engineer II..,Media Services Engineering
17781,Cathleen Rosales,F,3/6/88,32,58367,52539,5828,Recruiter II..,Talent Acquisition
19748,Dane Pena,M,17/02/1989,31,57994,52513,5481,Talent Sourcing and Research Specialist II..,Talent Acquisition
21557,Rosetta Fuller,F,23/10/1988,31,57159,48697,8462,Business Systems Analyst..,Enterprise Infrastructure Services
21177,Jesse Shaffer,M,26/04/1990,30,56187,50337,5850,Network Implementation Manager..,Networks - APJ Infrastructure
15665,Judson Mann,M,21/02/1990,30,57944,50347,7597,Lab Manager II..,Networks - Americas Infrastructure
12349,Stacy Meadows,F,26/04/1991,29,59531,45185,14346,Contract/Billing Analyst II..,Finance - Customer Revenue Operations G&A
18470,Bessie Brennan,F,20/07/1995,24,56542,38114,18428,Software Engineer II..,IT DevOps
19017,Aldo Barajas,M,26/01/1991,29,58477,52002,6475,Network Infrastructure Engineer..,Networks - APJ Infrastructure
18087,Keneth Frost,M,21/06/1997,23,56348,47293,9055,Platform Operations Engineer.Associate.,Platform Operations
18868,Maria Proctor,M,12/1/92,28,57795,51071,6724,Technical Solutions Engineer..,AmaTec - Weekend TSE
16401,Duncan Dominguez,M,27/09/1991,28,59643,42799,16844,Systems Engineer..,GSS EPIC Engineering (HC COGS)
17259,Miquel Marshall,M,16/04/1984,36,59738,50014,9724,Documentation and Training Specialist..,Engineering Learning
21583,Cortez Blackburn,M,6/5/93,27,59293,50040,9253,Platform Operations Engineer..,Platform Operations
22787,Nikki Schroeder,F,18/05/1994,26,56873,53618,3255,Technical Solutions Engineer..,AmaTec - Americas TSE
10888,Kirsten Valencia,F,24/04/1989,31,57051,43353,13698,Marketing Program Specialist..,Campaign Optimization
9470,Vicente Garrison,M,20/07/1991,28,57767,39430,18337,Marketing Program Specialist..,Media APJ Field Marketing
22951,Brett Mayo,M,3/12/88,31,60051,56846,3205,Business Operations Analyst II..,Web Strategy
15483,Dirk Reed,M,27/02/1987,33,57314,47791,9523,Client Service Manager.Senior.,EMEA - AMG
16250,Jerold Foley,M,27/01/1992,28,58994,50822,8172,Technical Solutions Engineer..,AmaTec - Weekend TSE
16355,Rosalind Henry,F,4/9/94,25,58775,49219,9556,Solutions Architect..,Service Delivery EMEA
18578,Glen Silva,M,6/10/92,27,57386,49277,8109,Platform Operations Engineer.Associate.,Platform Operations
16721,Margarito Navarro,M,3/11/94,25,58633,43697,14936,Technical Solutions Engineer..,AmaTec - Americas TSE
19514,Michal Wilcox,M,28/11/1993,26,60611,51936,8675,Software Engineer II..,Enterprise Applications
6161,Jamey Ortega,M,8/7/83,37,58441,48260,10181,Contract/Billing Analyst.Senior Lead.,Finance - Customer Revenue Operations G&A
21814,Mel Miles,M,8/12/94,25,58441,48534,9907,Platform Operations Engineer..,Platform Operations
17400,Lyman Sparks,M,28/07/1993,26,60268,55770,4498,Business Operations Analyst II..,Global Sales Ops
23030,Tracy Diaz,M,17/07/1992,27,59768,56566,3202,Software Engineer II..,Enterprise Applications
11251,Dewayne Moran,M,23/10/1991,28,60304,43826,16478,Finance Systems Analyst..,Financial Planning and Analysis
12398,Bret Jennings,M,5/2/84,36,57922,41467,16455,Program Manager..,Global Channel - Programs Support
8881,Bessie Summers,F,7/9/78,41,59699,50525,9174,Office Manager..,Global Real Estate and Workplace Productivity
22095,Olen Ortiz,M,21/03/1993,27,59017,51883,7134,Technical Solutions Engineer.Associate.,AmaTec - APJ TSE
17861,Denver Hebert,M,6/12/91,28,57697,49536,8161,Systems Support Engineer II..,IT DevOps
14785,Aldo Daniel,M,21/08/1990,29,59915,51729,8186,Contract/Billing Analyst.Senior.,Finance - Customer Revenue Operations G&A
20955,Milton Adkins,M,17/12/1993,26,57508,46633,10875,Platform Operations Engineer.Associate.,Platform Operations
22727,Booker Hodge,M,10/8/94,25,60081,50425,9656,Systems Support Engineer II..,IT DevOps
20030,Kate Kane,F,31/08/1992,27,60463,53072,7391,Security Operations Technician.Senior.,APJ Security Services - SOCC
11930,Rory Bautista,M,5/12/86,33,61500,40299,21201,Corporate Services Specialist.Senior Lead.,Global Real Estate and Workplace Productivity
19707,Hollie Mcneil,F,7/5/91,29,59146,46427,12719,Software Development Engineer in Test II..,IT DevOps
14435,Lavern Santos,M,27/04/1990,30,59251,45348,13903,Collections Specialist.Senior.,Finance - Customer Revenue Operations G&A
17868,Eloise Mccoy,F,8/5/83,37,58505,49533,8972,Release Engineer II..,Media Services Engineering
20650,Ofelia Foley,F,7/7/95,25,60877,52054,8823,Media Operations Engineer.Associate.,Amatec - BOCC/EMM
18339,Nora Malone,F,6/2/93,27,61241,48689,12552,Services Analyst II..,Service Delivery Excellence
22549,Marion Oconnor,F,22/08/1993,26,58665,51207,7458,Technical Solutions Engineer..,AmaTec - Americas TSE
21808,Jeromy Pacheco,M,5/3/91,29,59455,51037,8418,Technical Solutions Engineer.Associate.,AmaTec - EMEA TSE
10708,Lincoln Rosales,M,10/12/90,29,59230,51307,7923,Order Analyst.Senior.,Finance - Customer Revenue Operations G&A
11202,Arnoldo Simon,M,1/5/82,38,58168,51588,6580,Contract/Billing Analyst.Senior.,Finance - Customer Revenue Operations G&A
18770,Maynard Benjamin,M,19/04/1990,30,58311,45882,12429,Technical Solutions Engineer..,AmaTec - EMEA TSE
17665,Misty Warner,F,17/12/1994,25,60903,52380,8523,Technical Solutions Engineer..,AmaTec - Americas TSE
17221,Harry Cook,M,15/10/1994,25,62279,44189,18090,Software Engineer II..,LUNA/OPEN Engineering
19197,Keith Lopez,M,9/6/88,32,59063,51654,7409,Program Manager..Technical,Service Delivery EMEA
20075,Bill Murillo,M,1/6/94,26,59593,49378,10215,Systems Engineer..,GSS EPIC Engineering (HC COGS)
17247,Kristy Orozco,F,11/4/95,25,62277,53728,8549,Software Engineer II..,GSS EPIC Engineering (HC COGS)
11464,Alfonso Oneal,M,2/8/85,34,58496,44622,13874,Product Operations Analyst II..,IT Product Management & Ops
17273,Christi Mccoy,F,3/7/91,29,62240,44861,17379,Product Operations Analyst II..,IT Product Management & Ops
22178,Glen Sutton,M,14/11/1994,25,59224,52169,7055,Platform Operations Engineer..,Platform Operations
12255,Jeromy Calderon,M,26/01/1988,32,60235,51267,8968,Client Service Manager.Senior.,APJ - AMG
16140,Hipolito Dickerson,M,19/12/1985,34,59228,44730,14498,Network Infrastructure Engineer..,Networks - APJ Infrastructure
16914,Cristobal Parks,M,10/5/87,33,62401,54308,8093,Security Operations Technician II..,APJ Security Services - SOCC
17904,Horace Russell,M,13/12/1993,26,60174,41591,18583,Software Engineer II..,AmaTec - APS
8744,Lou Mills,M,7/11/86,33,59448,52982,6466,Product Operations Analyst II..,IT Product Management & Ops
20605,Cristopher Hardy,M,1/9/92,27,60747,47352,13395,Q/A Engineer II..,IT DevOps
6586,Joshua Warner,M,21/12/1983,36,61422,52933,8489,Collections Specialist.Senior.,Finance - Customer Revenue Operations G&A
20636,Rosalind Browning,F,20/03/1993,27,62893,48521,14372,Media Operations Engineer..,Amatec - BOCC/EMM
15299,Brian Trevino,M,2/2/94,26,59120,57720,1400,Platform Operations Engineer II..,Platform Operations
14530,Calvin Gonzales,M,22/02/1989,31,60829,52223,8606,Commissions Analyst II..,Finance - Commissions & Marketing
8848,Graciela Randolph,F,11/9/89,30,59831,51740,8091,Deal Desk Analyst II..,Finance - Customer Revenue Operations S&M
7107,Will Berry,M,28/05/1980,40,62525,33259,29266,Revenue Accountant II..,Finance - Accounting
18998,Vaughn Horton,M,12/6/92,28,59185,46254,12931,Technical Solutions Engineer..,AmaTec - Americas TSE
4998,Chas Petersen,M,26/08/1986,33,61991,55588,6403,Help Desk Specialist..,Enterprise Infrastructure Services
18773,Arnulfo Snow,M,31/12/1988,31,60680,48131,12549,Product Operations Analyst II..,IT Product Management & Ops
16288,Willis Church,M,5/7/92,28,61427,41571,19856,Solutions Architect..,Service Delivery Americas Web
17334,Royce Shelton,M,26/09/1990,29,61026,50706,10320,Solutions Architect..,Service Delivery Americas Web
8197,Bernie Cisneros,M,1/10/83,36,61699,49535,12164,Payroll Analyst.Senior.,Finance - Accounting
15693,Deon Santana,M,31/05/1994,26,60165,44202,15963,Software Engineer II..,Corporate Systems
18759,Trina Ho,F,18/01/1994,26,60062,49138,10924,Technical Solutions Engineer..,AmaTec - Weekend TSE
14531,Lottie Johnston,F,26/07/1990,29,62640,51780,10860,Network Engagement Consultant II..,Networks - APJ Infrastructure
16361,Marissa Foley,F,3/8/94,25,62663,50001,12662,Network Infrastructure Engineer..,Networks - APJ Infrastructure
14686,Filiberto Barrera,M,1/7/88,32,61371,53596,7775,Order Analyst.Senior.,Finance - Customer Revenue Operations G&A
9258,Elizabeth Horne,F,8/11/84,35,62275,45497,16778,Business Operations Analyst II..,Service Delivery Excellence
17973,Forrest Walton,M,15/02/1990,30,61494,53027,8467,Technical Solutions Engineer..,AmaTec - Americas TSE
18461,Leon Pugh,M,25/11/1995,24,63629,42968,20661,Software Engineer II..,Web Performance Engineering
7266,Lilly Lindsey,F,16/10/1985,34,60437,48960,11477,Order Analyst.Senior Lead.,Finance - Customer Revenue Operations G&A
22784,Bradley Jarvis,M,20/06/1989,31,63630,60267,3363,Global Corporate Card Specialist.Senior.,Global Procurement
22173,Corina Castro,F,19/09/1985,34,61929,51418,10511,Channel Marketing Specialist.Senior.,Web Global Channel Marketing
22560,Calvin Jacobs,M,11/12/90,29,61183,57640,3543,Business Systems Analyst..,Enterprise Applications
22865,Lilly Hoffman,F,1/11/93,26,60875,57485,3390,Program Manager..,GSS Global Programs
22363,Rae Diaz,F,20/12/1988,31,62152,53752,8400,Solutions Architect..,Service Delivery EMEA
16188,Mohammad Glass,M,25/07/1987,32,59990,52003,7987,Client Service Manager.Senior.,EMEA - AMG
21475,Coy Mack,M,15/07/1987,33,62795,54234,8561,Security Operations Technician.Senior.,APJ Security Services - SOCC
16242,Elton Ho,M,11/4/89,31,62105,54611,7494,Technical Solutions Engineer..,AmaTec - APJ TSE
18588,Ellen Carey,F,4/6/90,30,62947,55082,7865,Technical Solutions Engineer..,AmaTec - Americas TSE
10705,Edgardo Sanford,M,31/05/1988,32,61487,42877,18610,Order Analyst.Senior.,Finance - Customer Revenue Operations G&A
16341,Agnes Holloway,F,4/11/94,25,60080,40994,19086,Software Development Engineer in Test II..,Media Experience SQA
22903,Wanda Mckenzie,F,27/04/1993,27,60655,56942,3713,Business Operations Analyst II..,Marketing Data Analytics
22799,Susanne Zhang,F,13/09/1995,24,63074,58824,4250,Software Engineer II..,Media Delivery Product Engineering
15478,Morton Velasquez,M,25/05/1987,33,63372,59109,4263,Infrastructure Delivery Manager..,Networks - EMEA Infrastructure
18714,Pauline Herman,F,10/10/91,28,62639,54739,7900,Solutions Architect..,Service Delivery APJ
11521,Kerry Donovan,M,20/09/1986,33,61885,52681,9204,Billing Specialist.Senior.,Finance - Customer Revenue Operations G&A
17218,Mauricio Cervantes,M,29/01/1996,24,63771,43879,19892,Software Engineer II..,Web Performance Engineering
16861,Ernest Mahoney,M,10/4/89,31,63927,55214,8713,Platform Operations Engineer..,Platform Operations
20024,Sean Snyder,M,31/03/1994,26,60896,52954,7942,Technical Solutions Engineer.Associate.,AmaTec - APJ TSE
14236,Leticia Howe,F,1/7/89,31,60314,52205,8109,Software Engineer II..,CIO Management
8383,Frieda Tran,F,9/1/88,32,61026,51452,9574,Client Service Manager.Senior.,EMEA - AMG
22247,Isabel Daugherty,F,2/3/92,28,63049,53500,9549,Platform Operations Engineer..,Platform Operations
16440,Ty Conway,M,24/08/1982,37,62191,49731,12460,Client Service Manager.Senior.,EMEA - AMG
17661,Stan Nash,M,10/3/94,26,62111,53879,8232,Technical Solutions Engineer..,AmaTec - Americas TSE
9827,Alton Travis,M,20/02/1990,30,61380,44009,17371,Network Implementation Manager Ii..,Networks - APJ Infrastructure
22394,Yvette Buchanan,F,31/10/1991,28,64087,57182,6905,Technical Solutions Engineer..,AmaTec - Americas TSE
23047,Chung Morgan,M,31/03/1991,29,60624,57305,3319,Solutions Architect II..,APJ Security Services
19568,Winston Melton,M,27/04/1993,27,63973,57397,6576,Software Engineer II..,Enterprise Applications
12058,Felicia Shannon,F,31/12/1991,28,63706,55955,7751,Order Analyst.Senior.,Finance - Customer Revenue Operations G&A
18321,Jere Lane,M,10/5/89,31,62181,52744,9437,Network Infrastructure Engineer..,Networks - APJ Infrastructure
16233,Beatrice Patterson,F,2/1/87,33,63908,54308,9600,Client Service Manager.Senior.,Americas- AMG
22190,Krystal Mckee,F,10/9/93,26,62647,53662,8985,Solutions Architect..,APJ Security Services
23022,Gracie Shelton,F,13/04/1991,29,62311,59003,3308,Software Engineer II..,App Architecture & Integration Services
16248,Pauline Clarke,F,22/05/1993,27,64232,55635,8597,Client Service Manager..,Americas- AMG
18472,Elvia Ewing,F,11/11/90,29,62082,43434,18648,Services Analyst II..,Service Delivery Excellence
15856,Denver Stephenson,M,2/10/89,30,62500,52138,10362,Platform Operations Engineer II..,Platform Operations
9941,Mariano Howell,M,10/3/88,32,62097,50616,11481,Contract/Billing Analyst.Senior Lead.,Finance - Customer Revenue Operations G&A
11305,Elisa Benson,F,31/05/1990,30,61426,54743,6683,Software Engineer II..,Enterprise Applications
17213,Josh Pace,M,21/04/1995,25,61266,44025,17241,Software Engineer II..,Enterprise Applications
14346,Gretchen Harrell,F,13/09/1986,33,61380,48332,13048,Learning & Development Specialist II.Lead.,International - Learning & Dev
16238,Therese Melendez,F,13/08/1994,25,61749,53727,8022,Technical Solutions Engineer..,AmaTec - Americas TSE
18478,Clare Bradley,F,30/12/1994,25,64867,48025,16842,Software Engineer II..,Media Ghost
20734,Alec Ingram,M,30/06/1986,34,64023,41713,22310,Network Implementation Manager..,Networks - APJ Infrastructure
20977,Dino Curry,M,20/10/1989,30,64484,43173,21311,Financial Analyst II..,Web Division Finance
16489,Sybil Townsend,F,31/01/1991,29,64064,53111,10953,Solutions Architect..,Service Delivery Americas Media
18959,Lea Norris,F,13/04/1993,27,62238,45201,17037,Software Development Engineer in Test II..,Media Services Engineering
22614,Olen Yoder,M,3/6/95,25,61563,58367,3196,Platform Operations Engineer..,Platform Operations
15610,Dion Wiggins,M,18/12/1988,31,61564,42665,18899,Server Tech Services Engineer II.Lead.,Networks - EMEA Infrastructure
18629,Gabriel Morgan,M,14/12/1990,29,61544,53793,7751,Solutions Architect..,GSS EPIC Product Evaluation
4004,Edison Miranda,M,21/12/1984,35,63628,54972,8656,Business Operations Analyst II..,IT Business Process Improvement & Change Mgmt
22634,Mohamed Rocha,M,14/09/1992,27,64168,42640,21528,Software Development Engineer in Test II..,Media Portal
22552,Eric Mckee,M,8/6/90,30,64990,44543,20447,Systems Support Engineer II..,Developer Productivity
22551,Denis Durham,M,8/1/83,37,61382,48134,13248,Network Administrator II..,Enterprise Infrastructure Services
22217,Michelle Daugherty,F,20/10/1992,27,64262,56534,7728,Q/A Engineer II..,IT DevOps
19470,Benito Owen,M,27/01/1989,31,65065,45402,19663,Solutions Architect..,Service Delivery APJ
19790,Chase Fernandez,M,20/03/1993,27,64312,64202,110,Order Analyst..,Finance - Customer Revenue Operations G&A
21787,Desiree Contreras,F,27/08/1992,27,61926,58613,3313,Technical Solutions Engineer..,AmaTec - CIAM
21067,Granville Armstrong,M,22/01/1991,29,63700,60726,2974,Systems Administrator..,Enterprise Infrastructure Services
22455,Elijah Austin,M,18/05/1994,26,62989,56211,6778,Technical Solutions Engineer..,AmaTec - Americas TSE
16769,Octavio Bentley,M,25/06/1988,32,62920,45472,17448,Client Service Manager.Senior.,Americas- AMG
17703,Lessie Irwin,F,17/02/1991,29,64234,54588,9646,Product Operations Analyst II..,IT Product Management & Ops
22278,Cody Dorsey,M,4/3/93,27,64000,52052,11948,Platform Operations Engineer..,Platform Operations
20887,Gavin Chen,M,3/10/93,26,64257,54130,10127,Media Operations Engineer..,Amatec - BOCC/EMM
7074,Pete Kaiser,M,12/2/86,34,64453,54751,9702,Billing Specialist.Senior Lead.,Finance - Customer Revenue Operations G&A
20638,Eddie Morrow,F,27/11/1992,27,64602,57565,7037,Media Operations Engineer..,Amatec - BOCC/EMM
19354,Richard Atkinson,M,7/12/91,28,62154,53352,8802,Software Engineer II..,Enterprise Applications
22864,Willard Morrison,M,10/6/90,30,61666,57983,3683,Technical Solutions Engineer..,AmaTec - Americas TSE
20907,Clint Mccann,M,24/08/1991,28,63245,43717,19528,Software Engineer..,LUNA/OPEN Engineering
22012,Nathanael Sampson,M,1/12/92,27,63891,54259,9632,Technical Solutions Engineer..,AmaTec - CIAM
10707,Devin Hernandez,M,30/12/1987,32,65631,46337,19294,Order Analyst.Senior.,Finance - Customer Revenue Operations G&A
10974,Jamison Lam,M,2/9/86,33,64443,54785,9658,Booking Operations Analyst.Senior.,Financial Planning and Analysis
6869,Karyn Miles,F,10/6/88,32,62120,61020,1100,Technical Account Manager.Senior.,Acquisitions - ECG IAE Pre-Sales
21611,Dorsey Blankenship,M,10/2/91,29,64418,44128,20290,Solutions Architect..,Service Delivery Americas Web
14937,Lourdes Wolfe,F,2/10/85,34,62761,50862,11899,Solutions Architect II..,GSS EPIC Product Evaluation
22276,Delores Joseph,F,28/09/1991,28,63512,54139,9373,Release Engineer II..,Storage Engineering
14652,Sherrie Curry,F,21/06/1991,29,65372,53567,11805,Program Manager..Technical,CIO Management
9940,Basil Neal,M,14/12/1987,32,62473,50353,12120,Client Service Manager.Senior.,Americas- AMG
11235,Caleb Holloway,M,5/9/88,31,62919,53767,9152,Product Operations Analyst II..,IT Product Management & Ops
16313,Fannie Coleman,F,12/6/92,28,62894,60294,2600,Technical Solutions Engineer..,AmaTec - APJ TSE
17869,Lionel Campos,M,27/02/1994,26,65928,57593,8335,Software Engineer II..,LUNA/OPEN Engineering
10438,Leon Hayden,M,29/11/1983,36,63909,48126,15783,Partner Services Manager.Senior.,Americas- AMG
16627,Katharine Ellison,F,29/05/1989,31,64910,49838,15072,Client Service Manager.Senior.,EMEA - AMG
19711,Robby Blevins,M,10/2/93,27,64311,55038,9273,Software Engineer II..,Enterprise Applications
21399,Elliot Bowen,M,10/9/93,26,64872,54657,10215,Technical Solutions Engineer..,AmaTec - Americas TSE
10515,Howard Dorsey,M,7/7/89,31,63324,46477,16847,Product Operations Analyst II..,IT Product Management & Ops
6951,Lazaro Griffin,M,28/01/1983,37,63224,52293,10931,LMS Administrator II..,Learning & Development
16227,Clarissa Macdonald,F,26/04/1994,26,63168,33651,29517,Technical Solutions Engineer..,AmaTec - Americas TSE
18586,Galen Alvarado,M,25/06/1992,28,64867,56356,8511,Solutions Architect..,GSS EPIC Product Evaluation
14353,Patty Prince,F,29/01/1993,27,66332,46623,19709,Security Operations Center Specialist..,APJ Security Services - SOCC
14024,Aileen Gardner,F,11/3/86,34,65136,31421,33715,Client Service Manager.Senior.,Americas- AMG
19052,Modesto Murray,M,12/6/86,34,64551,51697,12854,Client Service Manager..,Americas- AMG
19574,Jeffry Salazar,M,26/07/1989,30,62902,43912,18990,Release Engineer.Senior.,IT DevOps
20406,Heath Jefferson,M,18/03/1991,29,65431,45515,19916,Security Operations Technician.Senior.,APJ Security Services - SOCC
16331,Jed Gates,M,10/7/94,26,63883,36252,27631,Software Engineer II..,IT DevOps
22245,Zachery Friedman,M,23/10/1993,26,63749,55441,8308,Technical Solutions Engineer..,AmaTec - Americas TSE
19618,Mitzi English,F,12/10/89,30,65261,55843,9418,Web Content Publisher.Senior.,Marketing - Website Management
17416,Hyman Morales,M,22/05/1991,29,64625,58458,6167,Software Development Engineer in Test II..,Web Shared Engineering - Performance
15692,Erick Hanson,M,27/03/1994,26,64200,47668,16532,Software Engineer II..,Enterprise Applications
4226,Rita Fitzgerald,F,23/08/1981,38,63963,53333,10630,Billing Specialist.Senior Lead.,Finance - Customer Revenue Operations G&A
21711,Summer Henderson,F,14/01/1988,32,65732,64983,749,Contract/Billing Analyst..,Finance - Customer Revenue Operations G&A
10137,Pat Crosby,F,12/1/83,37,65502,35229,30273,Collections Specialist.Senior.,Finance - Customer Revenue Operations G&A
19549,Penny Mendez,F,28/07/1982,37,64347,53558,10789,Business Operations Analyst II..,Global Sales Ops
21155,Garry Mullins,M,21/05/1992,28,64545,52529,12016,Technical Solutions Engineer..,AmaTec - Americas TSE
22452,Osvaldo Tyler,M,24/03/1993,27,64752,56474,8278,Software Engineer II..,Enterprise Applications
22031,Juan Ballard,M,11/12/93,26,64219,52929,11290,Software Engineer II..,Enterprise Applications
7642,Adalberto Lloyd,M,16/06/1985,35,64125,46973,17152,Order Analyst.Senior Lead.,Finance - Customer Revenue Operations G&A
20790,Lane Kennedy,M,5/10/90,29,67215,48845,18370,Media Operations Engineer..,Amatec - BOCC/EMM
11248,Damon Villanueva,M,8/12/82,37,66832,54757,12075,Client Service Manager.Senior.,Americas- AMG
22157,Clay Mccarthy,M,31/05/1990,30,66744,52623,14121,System Operations Engineer II..,Media Reliability Engineering
15092,Bart Tapia,M,27/10/1985,34,64878,55690,9188,Client Service Manager..,Americas- AMG
22836,Tristan Padilla,M,10/3/91,29,65410,62716,2694,Technical Solutions Engineer..,AmaTec - Americas TSE
10106,Edwina Romero,F,22/09/1989,30,66937,48105,18832,Contract/Billing Analyst.Senior.,Finance - Customer Revenue Operations G&A
16243,Cecile Morgan,F,28/07/1992,27,66006,50985,15021,Solutions Architect..,Service Delivery Americas Web
22436,Donnie Blevins,M,2/1/94,26,65645,57899,7746,Technical Solutions Engineer..,AmaTec - Americas TSE
18765,Doug Glass,M,1/3/84,36,64400,43625,20775,Business Operations Analyst II..,Web Division Sales Ops
11023,Annmarie Ruiz,F,24/06/1985,35,67522,41233,26289,Contract/Billing Analyst.Senior.,Finance - Customer Revenue Operations G&A
21716,Earnestine Mckay,F,21/04/1993,27,65635,54863,10772,Technical Solutions Engineer..,AmaTec - Americas TSE
5004,Alejandro Schneider,M,20/09/1985,34,64857,55119,9738,Booking Operations Analyst.Senior Lead.,Financial Planning and Analysis
22433,Janis Kelley,F,22/08/1994,25,66109,51404,14705,Software Engineer II..,Media Ghost
22996,Alonso Abbott,M,18/06/1995,25,66150,62627,3523,Technical Solutions Engineer..,AmaTec - Americas TSE
6447,Mallory Stein,F,6/9/89,30,66612,55906,10706,Solutions Architect II..,GSS EPIC Product Evaluation
6958,Rufus Koch,M,10/7/81,39,68034,54513,13521,Revenue Accountant II..,Finance - Accounting
21937,Eusebio Mcguire,M,13/03/1989,31,65719,55787,9932,Technical Solutions Engineer..,AmaTec - EMEA TSE
5543,Gina Prince,F,18/05/1983,37,65944,57145,8799,Logistics Analyst.Lead.,Networks - EMEA Infrastructure
21090,Thad Bass,M,25/06/1993,27,64517,51684,12833,Data Engineer II..,Data Engineering Analytics & Intelligence
6991,Ollie Owen,F,4/5/83,37,65065,57193,7872,Client Service Manager.Senior.,EMEA - AMG
8691,Owen Little,M,29/08/1982,37,67613,58420,9193,Client Service Manager.Senior.,Americas- AMG
17001,Carlo Robinson,M,21/04/1986,34,67447,50899,16548,Security Analyst.Senior.,Enterprise Architecture and Security
9150,Alissa Pacheco,F,18/12/1989,30,66884,55640,11244,Client Service Manager.Senior.,Americas- AMG
21715,Mandy Becker,F,8/10/93,26,64645,53558,11087,Solutions Architect..,Service Delivery Americas Web
3860,Jude Benson,M,5/3/82,38,66692,56921,9771,Client Service Manager.Senior.,APJ - AMG
18999,Juliet Soto,F,1/2/89,31,67593,47618,19975,Q/A Engineer.Senior.,IT DevOps
17214,Adan Baxter,M,4/4/94,26,65773,52605,13168,Software Engineer II..,LUNA/OPEN Engineering
16100,Ellis Mendez,M,5/3/89,31,68058,59051,9007,Collections Specialist.Senior.,Finance - Customer Revenue Operations G&A
17211,Gloria Bennett,F,20/10/1990,29,66677,53502,13175,Business Systems Analyst.Senior.,Corporate Systems
16245,Everett Wade,M,6/5/93,27,65772,52100,13672,Technical Solutions Engineer II..,AmaTec - APJ TSE
10503,Nathanael Campos,M,29/08/1984,35,66687,46889,19798,Client Service Manager.Senior.,APJ - AMG
16249,Scot Lee,M,27/10/1991,28,68397,59179,9218,Technical Solutions Engineer..,AmaTec - Americas TSE
19605,Kelley Sherman,M,7/9/88,31,65606,54374,11232,Systems Administrator..Windows,Enterprise Infrastructure Services
5637,Gilda Frazier,F,22/12/1981,38,68036,58399,9637,Collections Specialist.Senior Lead.,Finance - Customer Revenue Operations G&A
20577,Emmitt Yu,M,10/10/90,29,67531,55072,12459,System Operations Engineer..,Media Reliability Engineering
16230,Alison Orozco,F,24/06/1994,26,68112,59146,8966,Technical Solutions Engineer II..,AmaTec - APJ TSE
16357,Bridgette Todd,F,19/12/1994,25,67822,49308,18514,Solutions Architect..,Service Delivery Americas Web
8870,Nathanial Andersen,M,26/03/1987,33,66065,40343,25722,Client Service Manager.Senior.,Americas- AMG
22815,Jaime Maldonado,F,7/9/96,23,67170,63618,3552,Software Engineer..,Enterprise Networks
16318,Benita Bolton,F,15/05/1990,30,65615,56622,8993,Platform Operations Engineer II..,Platform Operations
21691,Jared Hoffman,M,11/8/94,25,68047,58268,9779,Technical Solutions Engineer..,AmaTec - Americas TSE
23029,Trevor Castaneda,M,13/10/1995,24,65542,61905,3637,Systems Engineer II..,Developer Productivity
21968,Wyatt Chaney,M,26/10/1993,26,68989,47084,21905,Technical Solutions Engineer..,AmaTec - Americas TSE
10265,Dave Fritz,M,23/11/1983,36,65724,30428,35296,Contract/Billing Analyst.Senior.,Finance - Customer Revenue Operations G&A
7643,Erin Camacho,M,26/06/1985,35,68739,48537,20202,Order Analyst.Senior Lead.,Finance - Customer Revenue Operations G&A
11881,Arden Gaines,M,27/07/1990,29,68981,52213,16768,Systems Engineer..,Platform Enablement_OLD
20031,Callie Melendez,F,2/4/88,32,69307,59299,10008,Media Operations Engineer..,Amatec - BOCC/EMM
20632,Aurelio Powell,M,22/11/1989,30,68061,50260,17801,Client Service Manager..,Americas- AMG
20645,Evangeline Mata,F,29/11/1992,27,66854,39688,27166,Software Engineer II..,Enterprise Applications
10125,Travis Sanders,M,13/01/1987,33,65882,51492,14390,Software Engineer II..,Corporate Systems
20465,Jenifer Montgomery,F,27/08/1993,26,66743,42733,24010,Software Development Engineer in Test II..,IT DevOps
22842,Chang Small,M,5/2/94,26,68978,65527,3451,Release Engineer II..,Media Services Engineering
14943,Normand Weeks,M,19/05/1989,31,67070,46764,20306,Q/A Engineer.Senior.,IT DevOps
17877,Rosemarie Melendez,F,16/03/1990,30,65636,45392,20244,Business Systems Analyst.Senior.,Corporate Systems
23025,Xavier Petty,M,1/6/93,27,67163,63485,3678,Security Operations Center Specialist II..,APJ Security Services - SOCC
22553,Odell Lawson,M,30/10/1993,26,67183,59926,7257,Technical Solutions Engineer..,AmaTec - Americas TSE
22216,Sonia Moran,F,26/09/1991,28,68441,58788,9653,Software Development Engineer in Test II..,Enterprise Center
22772,Jackie Fernandez,M,2/8/94,25,68616,62002,6614,Software Engineer II..,DPM Engineering
17837,Edmund Rich,M,15/10/1991,28,66921,56222,10699,Talent Sourcing and Research Specialist II..,Talent Acquisition
10045,Catalina Tran,F,24/12/1981,38,68789,48666,20123,Channel Support Manager..,Global Channel - Programs Support
22170,Leola Page,F,5/7/92,28,66363,56719,9644,Technical Solutions Engineer..,AmaTec - APJ TSE
21028,Rafael Barrera,M,22/12/1991,28,66731,31225,35506,Business Systems Analyst.Senior.,Corporate Systems
20654,Sid Warner,M,20/04/1990,30,66353,50613,15740,Solutions Architect..,Service Delivery Americas Web
10009,Robbie Anthony,M,13/12/1980,39,68850,57598,11252,Client Service Manager.Senior.,Americas- AMG
15648,Marion Mora,M,26/07/1989,30,68846,60103,8743,Technical Solutions Engineer II..,AmaTec - Americas TSE
14629,Armand Davis,M,4/3/79,41,69983,56744,13239,Client Service Manager.Senior.,Americas- AMG
11584,Marina Potter,F,9/6/92,28,68403,57919,10484,Q/A Engineer.Senior.,IT DevOps
15051,Brice Downs,M,21/03/1994,26,68935,59510,9425,Software Engineer II..,Developer Productivity
22905,Justin Drake,M,21/05/1992,28,69168,66326,2842,Systems Support Engineer..,Networks - Productivity - Systems
14726,Antonia Carey,M,31/07/1985,34,69856,53882,15974,Platform Operations Engineer..,Platform Operations
9237,Armando Nash,M,5/2/90,30,69602,58075,11527,Technical Consultant..,Media AMER PreSales Inside Sales & ECG
19156,Emmett Ho,M,6/2/91,29,70650,57024,13626,Q/A Engineer.Senior.,IT DevOps
17338,Tania Yoder,F,22/08/1992,27,68457,58267,10190,Software Development Engineer in Test.Senior.,Media Experience SQA
18582,Diann Savage,F,29/11/1990,29,70662,63686,6976,Solutions Architect II..,Service Delivery Americas Media
19024,Bridget Sexton,F,6/9/93,26,70683,59493,11190,Solutions Architect..,Service Delivery Americas Media
19182,Susanna Vincent,F,24/06/1989,31,67785,57119,10666,Technical Solutions Engineer II..,AmaTec - APJ TSE
18885,Eugenio Stark,M,22/07/1991,28,67950,55561,12389,Solutions Architect II..,Service Delivery APJ
17027,Colby Alexander,M,16/04/1984,36,67449,58515,8934,Client Service Manager.Senior.,Americas- AMG
21718,Noah Orozco,M,15/10/1993,26,68844,49441,19403,Solutions Architect..,Service Delivery Americas Web
8277,Luke Meyer,M,24/07/1980,39,69215,44344,24871,Graphic Designer II..,Learning & Development
22275,Tuan Pennington,M,25/02/1994,26,68600,36494,32106,Software Engineer II..,Enterprise Applications
19588,Major Espinoza,M,29/05/1989,31,68811,59773,9038,Software Engineer.Senior.,Enterprise Applications
21564,Landon Gregory,M,10/11/91,28,71082,51690,19392,Solutions Architect..,Service Delivery Americas Web
15764,Lesley Dominguez,M,7/6/86,34,68495,57680,10815,Solutions Architect II..,Service Delivery APJ
12418,Otto Wiggins,M,8/3/88,32,68837,58650,10187,Platform Operations Engineer II..,Platform Operations
9446,Katharine Noble,F,26/09/1990,29,70117,57964,12153,Business Operations Analyst.Senior.,Media Division Sales Ops
16369,Julianne Dennis,F,26/01/1995,25,69710,28423,41287,Software Engineer II..,Enterprise Networks
10662,Rowena Oneal,F,29/09/1992,27,71261,59908,11353,Technical Solutions Engineer II..,AmaTec - APJ TSE
17752,Claud Jacobs,M,27/07/1992,27,69676,52259,17417,Software Engineer II..,LUNA/OPEN Engineering
11681,Glenna Moyer,F,11/1/90,30,69387,58543,10844,Q/A Engineer.Senior.,IT DevOps
20728,Efrain Bruce,M,6/9/91,28,69780,57908,11872,Software Engineer II..,Media Services Engineering
18481,Nickolas Gill,M,17/04/1991,29,68623,58056,10567,Solutions Architect II..,APJ Security Services
17788,Hal Burton,M,14/08/1988,31,70310,56966,13344,Talent Sourcing and Research Specialist II..,Talent Acquisition
19967,Nathanial Sosa,M,11/3/85,35,70583,59517,11066,Systems Administrator II..UNIX,Enterprise Infrastructure Services
22171,Karl Cherry,M,13/10/1989,30,69640,61346,8294,Infrastructure Delivery Manager..,Networks - APJ Infrastructure
19179,Alfreda Gill,F,6/5/91,29,72182,58165,14017,Software Development Engineer in Test.Senior.,Media Ghost
18734,Selma Mcgee,F,7/1/91,29,70452,50049,20403,Solutions Architect II..,Service Delivery APJ
15649,Darcy Estes,F,9/5/90,30,69109,59616,9493,Solutions Architect II..,GSS EPIC Product Evaluation
9828,Lynette Montoya,F,22/06/1986,34,70502,52278,18224,Logistics Analyst.Lead.,Networks - APJ Infrastructure
20574,Leonard Coffey,M,18/03/1994,26,70940,60204,10736,Solutions Architect..,Service Delivery Americas Web
3156,Asa Evans,M,26/12/1982,37,71729,57401,14328,Channel Support Manager..,Global Channel - Programs Support
22435,Bret Li,M,12/10/92,27,71193,54713,16480,Financial Analyst II..,Web Division Finance
14782,Martha Edwards,F,1/4/91,29,71529,59683,11846,Technical Solutions Engineer II..,AmaTec - Weekend TSE
9198,Marion Robertson,F,8/6/92,28,70578,59348,11230,Program Manager..Technical,GPO PMO & Business Operations
16779,Shirley Acevedo,M,10/6/94,26,69516,60386,9130,Platform Operations Engineer..,Platform Operations
22299,Isreal Herrera,M,7/1/90,30,70740,59580,11160,Software Engineer II..,Corporate Systems
4380,Alyson Cook,F,6/8/82,37,73040,63402,9638,Accounts Receivable Specialist.Senior.,Finance - Customer Revenue Operations G&A
15519,Morris Davenport,M,2/11/89,30,72841,31517,41324,Solutions Architect II..,Service Delivery Americas Web
18614,Kraig Boone,M,15/12/1990,29,70169,58798,11371,Business Systems Analyst.Senior.,Corporate Systems
18239,Jane Farmer,F,30/10/1983,36,70511,60060,10451,Documentation and Training Specialist.Senior.,Engineering Learning
10871,Rex Sanders,M,3/2/81,39,70787,59956,10831,Client Service Manager.Senior.,Americas- AMG
22372,Augusta Sutton,F,11/2/87,33,72555,63408,9147,Software Development Engineer in Test.Senior.,Dynamic Media SQA
17137,Del Patterson,M,30/09/1991,28,71253,61892,9361,Software Development Engineer in Test II..,Web Performance Engineering
18296,Norman Martinez,M,24/04/1990,30,72697,51739,20958,Solutions Architect II..,GSS EPIC Product Evaluation
15788,Wendy Moran,F,18/05/1991,29,72102,47701,24401,Solutions Architect II..,Service Delivery APJ
10637,Owen Johnston,M,1/7/92,28,72724,57378,15346,Systems Administrator II..UNIX,Enterprise Infrastructure Services
19970,Barbra Sosa,F,5/1/94,26,72601,49533,23068,Software Development Engineer in Test II..,Media Analytics
15789,Tracie Mora,F,2/10/88,31,70755,48500,22255,Solutions Architect II..,APJ Security Services
19069,Dallas Webb,M,15/09/1991,28,72030,59678,12352,Solutions Architect II..,GSS EPIC Product Evaluation
8792,Elwood Wheeler,M,23/01/1992,28,73425,65135,8290,Partner Enablement Manager.Senior.,Platform Operations
21719,Damon Harper,M,2/1/93,27,72507,57631,14876,Solutions Architect..,GSS EPIC CIAM
15384,Rudolf Short,M,6/6/91,29,73382,64295,9087,Software Development Engineer in Test.Senior.,Dynamic Media SQA
14917,Ted Blair,M,5/7/90,30,72529,38785,33744,Network Engineer..,Networks - Technology
9847,Melody Green,F,1/2/88,32,72746,52854,19892,Q/A Engineer.Senior.,IT DevOps
11503,Normand Donovan,M,22/04/1987,33,73202,49699,23503,Solutions Architect II..,GSS EPIC CIAM
18884,Allan Carr,M,22/12/1988,31,70543,61524,9019,Solutions Architect..,APJ Security Services
15279,Kristy Bowen,F,11/1/91,29,70775,55368,15407,Solutions Architect II..,Service Delivery APJ
15688,Ginger Rogers,F,7/10/94,25,71027,52329,18698,Software Development Engineer in Test.Senior.,Dynamic Media SQA
10709,Perry Collier,M,5/8/88,31,73900,65088,8812,Program Manager..,AmaTec - APS
8285,Rolf Robbins,M,9/10/88,31,71102,62335,8767,Recruiter II..,Talent Acquisition
19066,Erick Ballard,M,29/08/1992,27,70671,70561,110,Software Engineer II..,GSS EPIC Engineering (HC COGS)
15369,Terra Smith,F,29/10/1990,29,73434,57157,16277,Platform Operations Engineer II..,Platform Operations
11469,Ashlee Cochran,F,16/09/1992,27,74450,61209,13241,Network Design Engineer..,Networks - Productivity
16365,Roman Roth,M,16/11/1993,26,72674,53413,19261,Software Engineer II..,Enterprise Center
22051,Elwood Glass,M,10/12/94,25,71801,55916,15885,Software Engineer II..,Corporate Systems
17227,Wilson Ingram,M,17/07/1995,24,71988,47738,24250,Software Engineer II..,Media Services Engineering
19051,Hayden Mcknight,M,29/05/1989,31,72558,57280,15278,Site Reliability Engineer II..,LUNA/OPEN Engineering
20362,Paris Ewing,M,11/4/86,34,71676,57042,14634,Technical Account Manager..,Acquisitions - ECG IAE Pre-Sales
22118,Cora Terrell,F,25/07/1995,24,72074,60771,11303,Software Engineer II..,Media Delivery Product Engineering
22571,Milan Powers,M,14/04/1986,34,73870,64659,9211,Server Tech Services Engineer II.Lead.,Networks - APJ Infrastructure
6548,Dalton Pitts,M,28/07/1978,41,74240,63031,11209,Collections Specialist.Senior.,Finance - Customer Revenue Operations G&A
19658,Sang Wolfe,M,11/9/90,29,71830,55870,15960,Software Engineer II..,Media Services Engineering
20169,Jay Palmer,M,12/8/93,26,74012,61187,12825,Software Engineer II..,Media Ghost
14571,Reginald Page,M,1/7/93,27,73717,50289,23428,Software Engineer.Senior.,Enterprise Access Engineering
21642,Houston Olsen,M,25/10/1991,28,73409,63351,10058,Q/A Engineer II..,IT DevOps
4761,Basil Edwards,M,26/08/1978,41,74615,52372,22243,Partner Services Manager.Senior.,Americas- AMG
19397,Dale Sullivan,M,6/7/91,29,72311,55885,16426,Software Engineer II..,Networks - Productivity - Systems
16185,Zane Braun,M,9/7/91,29,74792,48452,26340,Solutions Architect II..,Service Delivery APJ
17152,Cherie Morrow,F,3/11/91,28,74623,48338,26285,Q/A Engineer.Senior.,IT DevOps
4070,Tanisha Villegas,F,17/12/1977,42,73028,57906,15122,Collections Supervisor..,Finance - Customer Revenue Operations G&A
11232,Herman Garza,M,14/09/1989,30,73088,63897,9191,Platform Operations Engineer II..,Platform Operations
11295,Christine Blake,F,1/7/89,31,74641,58052,16589,Solutions Architect II..,GSS EPIC Product Evaluation
12161,Estelle Clark,F,24/04/1990,30,72530,42522,30008,Systems Administrator II..UNIX,Enterprise Infrastructure Services
19456,Vicki Braun,F,8/1/85,35,73238,49860,23378,Business Systems Analyst.Senior.,Enterprise Applications
10663,Carol Perez,F,5/5/92,28,72321,52221,20100,Software Engineer II..,Media Ghost
17903,Cedrick Booth,M,25/05/1989,31,74674,60851,13823,Systems Engineer..,Enterprise Infrastructure Services
14586,Hal Henderson,M,13/08/1992,27,72921,57190,15731,Solutions Architect II..,Service Delivery APJ
22448,Jaime Tate,M,22/08/1993,26,73131,62525,10606,Software Development Engineer in Test.Senior.,Media Experience SQA
20254,Erich Santos,M,9/5/94,26,73673,60104,13569,Software Engineer II..,GSS EPIC Engineering (HC COGS)
10650,Cecelia Lynn,F,1/6/93,27,72467,58974,13493,Performance Engineer II..,Product - Custom
6897,Terra Washington,F,23/10/1988,31,72365,46722,25643,Solutions Architect II..,Service Delivery EMEA
10972,Hugh Frye,M,20/01/1985,35,73427,59951,13476,Marketing Automation Specialist.Senior.,Marketing - Operations
19435,Eduardo Dixon,M,25/08/1985,34,75786,62272,13514,Network Engineer..,Enterprise Infrastructure Services
8941,Conrad Riddle,M,11/11/85,34,72910,38336,34574,Contract/Billing Analyst.Senior.,Finance - Customer Revenue Operations G&A
14429,Jordon Cardenas,M,15/10/1989,30,73447,50379,23068,Systems Administrator II..Windows,Enterprise Infrastructure Services
15763,Patricia Perez,M,2/11/90,29,75943,66993,8950,Technical Solutions Engineer II..,AmaTec - Americas TSE
22450,Lilian Garrison,F,30/11/1978,41,74673,52909,21764,Services Analyst II..,Service Delivery Excellence
20562,Bruce Bradshaw,M,26/10/1991,28,75202,54910,20292,Software Engineer II..,Media Delivery Product Engineering
22867,Victor Ayala,M,19/09/1994,25,74228,55800,18428,Software Engineer II..,Enterprise Applications
19368,Corinne Meza,F,16/06/1991,29,75836,44889,30947,Software Engineer.Senior.,Media Analytics
16438,Chris Bell,M,9/2/92,28,74410,64998,9412,Technical Solutions Engineer II..,AmaTec - Weekend TSE
7669,Willis Hicks,M,8/2/88,32,76160,57196,18964,Collections Specialist.Senior Lead.,Finance - Customer Revenue Operations G&A
12386,Paris Allen,M,26/11/1990,29,76434,63968,12466,Platform Operations Engineer II..,Platform Operations
16241,Leslie Ritter,M,1/12/89,30,74877,60239,14638,Technical Solutions Engineer II..,AmaTec - Americas TSE
22359,Colby Hines,M,25/08/1994,25,75929,55626,20303,Data Scientist..,Security Engineering
16138,Kristin Garza,F,16/01/1991,29,74247,48146,26101,Technical Project Manager II..,APJ Security Services
18896,Anton Wang,M,15/07/1992,28,74240,60887,13353,Systems Support Engineer.Senior.,IT DevOps
20854,Isaac Bautista,M,6/4/93,27,76733,64121,12612,Technical Solutions Engineer..,AmaTec - Americas TSE
14344,Cristobal Page,M,10/4/84,36,77444,66184,11260,Network Implementation Manager II.Lead.,Networks - APJ Infrastructure
15420,John Villarreal,M,22/02/1990,30,76855,48594,28261,Solutions Architect II..,Service Delivery EMEA
14731,Shelly Carrillo,F,30/07/1992,27,73902,47413,26489,Support Delivery Specialist..,AmaTec - APJ TSE
11168,Lolita Compton,F,7/2/91,29,77013,62286,14727,Software Development Engineer in Test.Senior.,Dynamic Media SQA
21132,Dean House,M,10/4/92,28,77633,59013,18620,Software Engineer II..,Networks - Productivity - Systems
16840,Rob Bauer,M,28/09/1991,28,75469,49518,25951,Solutions Architect II..,Service Delivery Americas Web
15388,Mel Hughes,M,24/03/1992,28,77191,52844,24347,System Operations Engineer.Senior.,Media Reliability Engineering
18860,Brigitte Gordon,F,30/07/1988,31,77109,52556,24553,Technical Account Manager..,Acquisitions - ECG IAE Pre-Sales
17356,Antione Osborne,M,18/11/1990,29,75935,47618,28317,Solutions Architect II..,Service Delivery EMEA
10934,Heidi Finley,F,3/3/94,26,77275,58243,19032,Platform Operations Engineer II..,Platform Operations
10651,Cecil Tran,M,20/09/1992,27,77017,56271,20746,Software Engineer.Senior.,Enterprise Applications
20193,Malik Bennett,M,4/6/90,30,77262,54000,23262,Software Engineer II..,Corporate Systems
9871,Deena Hughes,F,19/05/1990,30,75159,59450,15709,Infrastructure Delivery Manager II..,Networks - EMEA Infrastructure
14628,Jaime Munoz,M,23/11/1987,32,78504,57264,21240,Q/A Engineer.Senior.,GSS EPIC Engineering (HC COGS)
15482,Miles Colon,M,26/04/1985,35,78711,64234,14477,Partner Services Manager.Senior.,Americas- AMG
11671,Ezra Stewart,M,29/01/1989,31,76208,59916,16292,Q/A Engineer.Senior.,GSS EPIC Engineering (HC COGS)
20039,Katheryn Preston,F,11/12/89,30,77447,53454,23993,Security Operations Center Specialist..,APJ Security Services - SOCC
15555,Latisha Camacho,F,10/6/91,29,76277,48330,27947,Software Development Engineer in Test.Senior.,Media Portal
16773,Bettie Barber,F,22/07/1990,29,78423,64352,14071,Relationship Manager..,Web Americas Inside Sales East
8322,Tyler Booker,M,18/02/1989,31,76345,60917,15428,Network Infrastructure Engineer II..,Networks - EMEA Infrastructure
10324,Anderson Rollins,M,8/6/87,33,77484,55030,22454,Client Service Manager.Senior.,Americas- AMG
10735,Chris Oconnor,M,6/10/87,32,75143,61338,13805,Client Service Manager.Senior.,Americas- AMG
16433,Angela Mckenzie,F,10/5/87,33,76481,63195,13286,Business Systems Analyst.Senior.,Enterprise Applications
20524,Nikki Trevino,F,21/07/1989,30,76614,60028,16586,Infrastructure Delivery Manager..,Networks - APJ Infrastructure
18889,Milford Pollard,M,18/05/1988,32,76178,63034,13144,Technical Solutions Engineer II..,AmaTec - APJ TSE
22449,Jerry Fitzpatrick,F,21/04/1992,28,76776,68728,8048,Business Operations Analyst.Senior.,Marketing - Operations
18809,Raymond Henderson,M,22/08/1990,29,79201,67827,11374,Media Operations Engineer II..,AmaTec - BOCC
14257,Jewel Meza,F,5/12/87,32,78659,57241,21418,Business Operations Analyst.Senior.,Service Delivery Excellence
17085,Roland Castillo,M,20/02/1991,29,75732,49949,25783,Platform Operations Engineer II.Lead.,Platform Operations
5993,Terry Richard,M,8/9/83,36,79036,54047,24989,Hardware Performance Engineer II..,Networks - Technology
5690,Otis Leonard,M,25/09/1987,32,79308,54759,24549,Marketing Program Specialist.Senior.,Web Americas Field Marketing
20697,Bo Vance,M,24/12/1990,29,78039,51005,27034,Release Engineer.Senior.,IT DevOps
9712,Casey Poole,F,30/04/1983,37,78855,65271,13584,Client Service Manager.Senior II.,EMEA - AMG
9897,Sean Arnold,M,5/6/85,35,76528,49631,26897,Systems Administrator II..,Enterprise Infrastructure Services
22431,Derick Garcia,M,4/4/90,30,77352,71133,6219,Software Engineer II..,Enterprise Applications
22222,Ollie Herrera,F,12/3/88,32,79125,64983,14142,Business Operations Analyst.Senior.,Marketing - Operations
11156,Tobias Gregory,M,2/7/91,29,77729,71068,6661,Software Engineer.Senior.,Enterprise Applications
22987,Deshawn Roberts,M,17/10/1989,30,79918,75446,4472,Systems Administrator..Windows,Enterprise Infrastructure Services
10345,Grover Greene,M,5/12/80,39,76348,48258,28090,Lead..Account Management,EMEA - AMG
14996,Joshua Duran,M,15/10/1989,30,78704,57923,20781,Q/A Engineer.Senior.,IT DevOps
16547,Kate Kerr,F,26/08/1991,28,79337,62405,16932,Solutions Architect II..,APJ Security Services
8768,Dana Robbins,M,15/05/1988,32,76513,50786,25727,Web Developer II..,Marketing - Website Management
14584,Roderick Arias,M,12/8/93,26,78600,62695,15905,Software Engineer.Senior.,Enterprise Applications
14587,Young Cervantes,F,24/07/1993,26,77939,57460,20479,Solutions Architect II..,Service Delivery EMEA
15715,Casey Mclaughlin,M,30/07/1986,33,78419,62213,16206,Lead..Account Management,Americas- AMG
22814,Leslie Ponce,M,16/03/1988,32,78131,65844,12287,Security Operations Center Specialist II..,APJ Security Services - SOCC
16071,Timmy Poole,M,26/08/1992,27,80043,46746,33297,Software Engineer.Senior.,Enterprise Center
2815,Young Knapp,F,20/04/1970,50,78362,51323,27039,Accountant.Senior.,Finance - Accounting
10654,Spencer Archer,M,6/5/92,28,78234,49186,29048,Systems Engineer II..,Developer Productivity
8784,Lynne Mccann,F,2/5/91,29,81058,53725,27333,Network Design Engineer II..,Networks - Productivity
17103,Garth Gamble,M,4/4/91,29,77653,62880,14773,Systems Support Engineer.Senior.,IT DevOps
15096,Caroline Allison,F,15/05/1990,30,80873,55776,25097,Software Development Engineer in Test.Senior.,LUNA/OPEN Engineering
16002,Forrest Salazar,M,3/6/88,32,78068,67001,11067,Software Engineer II..,App Architecture & Integration Services
16524,Leonel Roman,M,29/03/1995,25,77789,64825,12964,Software Engineer II..,Media Delivery Product Engineering
17304,Rosario Pitts,F,6/2/89,31,80689,64589,16100,Solutions Architect II..,Service Delivery Americas Web
4830,Kim Serrano,F,21/09/1981,38,78101,57079,21022,Recruiter.Senior.,Talent Acquisition
8334,Sonny Owen,M,24/03/1986,34,79572,54143,25429,Business Operations Analyst.Senior.,Media Division Sales Ops
21617,Hunter Downs,M,16/08/1991,28,78566,55870,22696,Software Development Engineer in Test.Senior.,Enterprise Networks
16049,Dwayne Terrell,M,27/11/1989,30,80096,56492,23604,Network Support Consultant..,Networks - APJ Infrastructure
11026,Terrell Rush,M,3/4/88,32,78336,59189,19147,Network Infrastructure Engineer II..,Networks - EMEA Infrastructure
3245,Coleman Davies,M,17/02/1982,38,81258,48238,33020,Accountant.Senior.,Finance - Accounting
18542,Harrison Mcintyre,M,30/04/1991,29,78121,65845,12276,Software Engineer.Senior.,Enterprise Applications
4957,Barton Lin,M,13/09/1985,34,81770,63040,18730,Client Service Manager.Senior II.,APJ - AMG
22353,Lynda Benitez,F,11/11/92,27,78646,77418,1228,Client Service Manager..,Americas- AMG
14902,Winford Gutierrez,M,27/10/1990,29,80885,50893,29992,Solutions Architect II..,Service Delivery APJ
15817,Garth Lewis,M,14/10/1986,33,81925,67272,14653,Systems Administrator II..UNIX,Enterprise Infrastructure Services
15503,Lakisha Kennedy,F,15/11/1990,29,79612,70341,9271,Solutions Architect II..,GSS EPIC Product Evaluation
19949,Fred Dougherty,M,10/11/87,32,81614,64729,16885,Technical Account Manager..,Media AMER PreSales Inside Sales & ECG
16093,Randell Rosales,M,12/2/90,30,82455,45706,36749,Solutions Architect II..,GSS EPIC Product Evaluation
6475,Maureen Holland,F,15/11/1986,33,81258,67428,13830,Business Operations Analyst.Senior.,Web Strategy
19732,Nestor Brock,M,3/2/85,35,81845,58903,22942,Program Manager II..,Global Channel - Programs Support
20943,Kirby Sherman,M,31/01/1991,29,81525,66327,15198,Solutions Architect II..,Service Delivery DPM
4653,Clinton Swanson,M,14/07/1978,42,79509,62334,17175,Client Service Manager.Senior II.,APJ - AMG
19889,Nathanael Ross,M,31/05/1987,33,80191,69711,10480,Client Service Manager.Senior.,EMEA - AMG
4076,Jessie Montes,M,15/08/1982,37,82646,67487,15159,Client Service Manager.Senior II.,APJ - AMG
20817,Jules Humphrey,M,25/11/1990,29,81158,66108,15050,Media Operations Engineer..,Amatec - BOCC/EMM
14516,Eliseo Miles,M,3/11/88,31,81843,66791,15052,Systems Administrator II..Windows,Enterprise Infrastructure Services
16229,Tobias Christian,M,19/02/1992,28,81103,65248,15855,Technical Solutions Engineer II..,AmaTec - PSG
22999,Juanita Gross,F,7/2/92,28,80426,76995,3431,Business Operations Analyst..,Web Division Sales Ops
21793,Jody Knight,F,19/03/1993,27,81813,63037,18776,Software Engineer II..,Media Portal
16629,Dominic Ferrell,M,2/9/91,28,81924,57149,24775,Software Engineer.Senior.,Security Engineering
15263,Joey Ortiz,M,6/8/91,28,80474,66750,13724,Technical Project Manager II..,Web Americas - ECG
17929,Brett Rose,M,15/01/1991,29,82107,60379,21728,Solutions Architect II..,APJ Security Services
17175,Huey Hart,M,28/11/1992,27,81296,65720,15576,Solutions Architect II..,Service Delivery Americas Web
15380,Simone Parks,F,15/12/1991,28,80804,53248,27556,Solutions Architect II..,Service Delivery Americas Media
14171,Adalberto Hayden,M,31/03/1984,36,80532,63252,17280,Business Operations Analyst.Senior.,Global Sales Ops
8516,Carissa Cummings,F,9/1/87,33,81948,53285,28663,Performance Engineer.Senior.,Product - Custom
9859,Florine Porter,F,25/05/1992,28,81163,54361,26802,Software Engineer.Senior.,Enterprise Applications
8585,Robt Walsh,M,3/2/91,29,79914,59607,20307,Network Engineer..,Enterprise Infrastructure Services
18275,Tyrell Jacobson,M,30/09/1991,28,82013,53923,28090,Software Engineer.Senior.,Enterprise Applications
22866,Rachael Rosario,F,12/4/93,27,81089,72184,8905,Solutions Architect II..,Service Delivery DPM
19088,Deshawn Delgado,M,11/5/86,34,82430,59332,23098,Solutions Architect II..,Service Delivery APJ
15635,Simon Roach,M,23/08/1988,31,83436,69572,13864,Technical Solutions Engineer II..,AmaTec - APJ TSE
17381,Forrest Petersen,M,7/6/91,29,82934,66027,16907,Solutions Architect II..,GSS EPIC Product Evaluation
18779,Forest Clements,M,15/01/1994,26,82989,68716,14273,Technical Solutions Engineer II..,AmaTec - Americas TSE
9147,Gabrielle Fuller,F,8/11/90,29,83920,66058,17862,Performance Engineer II..,Product - Custom
15588,George Hobbs,M,20/12/1993,26,81915,45229,36686,Software Engineer II..,Corporate Systems
15260,Waldo Zamora,M,5/9/88,31,82431,69339,13092,Technical Solutions Engineer II..,AmaTec - Americas TSE
6358,Lane Armstrong,M,3/12/89,30,83372,52746,30626,Technical Solutions Engineer II..,AmaTec - Americas TSE
21166,Elvira Armstrong,F,18/01/1974,46,80598,50988,29610,Executive Assistant..,Web APJ Sales Mgmt
15278,Lorna Bryant,F,14/01/1991,29,83940,63696,20244,Solutions Architect II..,Service Delivery Americas Web
19644,Eli Pittman,M,29/07/1991,28,82835,53457,29378,Software Engineer.Senior.,Media Analytics
18637,Enrique Manning,M,6/9/89,30,80856,62221,18635,Technical Solutions Engineer II..,AmaTec - Americas TSE
20665,Garland Boyle,M,26/07/1988,31,81915,66671,15244,Product Operations Analyst.Senior.,IT Product Management & Ops
9829,Sebastian Cobb,M,18/08/1985,34,83922,66202,17720,Business Systems Analyst.Senior.,LUNA/OPEN Engineering
14411,Jesus Blankenship,M,11/1/88,32,81335,64935,16400,Channel Support Manager.Senior.,Global Channel - Programs Support
17406,Houston Padilla,M,10/2/90,30,84251,52756,31495,Software Development Engineer in Test.Senior.,Media Services Engineering
20978,Desmond Huff,M,24/07/1990,29,84724,68766,15958,Solutions Architect II..,Service Delivery Americas Media
18147,Lupe Nelson,F,10/9/90,29,82192,54917,27275,Technical Project Manager II..,Web Americas - ECG
20625,Wendell Valencia,M,19/05/1991,29,81198,64124,17074,Software Engineer II..,Media Portal
5920,April Ali,F,3/1/81,39,82232,66861,15371,Lead..Account Management,EMEA - AMG
23035,Lenore Blake,F,12/9/93,26,84702,80225,4477,Software Engineer.Senior.,GSS EPIC Product Management and Marketing
17317,Demetrius Flynn,M,21/04/1991,29,81327,48563,32764,Security Operations Center Specialist..,APJ Security Services - SOCC
20942,Doug Singleton,M,29/12/1989,30,81871,48314,33557,Business Operations Analyst.Senior.,Marketing - Operations
22678,Rick Costa,M,21/08/1992,27,83365,66501,16864,Solutions Architect II..,Service Delivery DPM
11046,Alphonso Andrews,M,11/10/89,30,84387,53707,30680,Technical Project Manager II..,APJ PS - SA/IN
10734,Cedric Mckinney,M,13/05/1988,32,81350,47341,34009,Business Systems Analyst.Senior.,Corporate Systems
9356,Carroll Mercado,M,29/12/1983,36,82045,65304,16741,Technical Project Manager II..,APJ Security Services
16551,Eldridge Mclaughlin,M,4/7/89,31,82059,49887,32172,Software Engineer.Senior.,Corporate Systems
15712,Elmo Cooper,M,17/01/1991,29,81560,77697,3863,Solutions Architect II..,Service Delivery Americas Media
9197,Nannie Kane,F,6/4/91,29,82515,64763,17752,Solutions Architect II..,Service Delivery APJ
4977,Del Briggs,M,1/8/75,44,84199,66127,18072,Accountant.Senior.,Finance - Accounting
17112,Paul Doyle,M,2/12/83,36,83741,64135,19606,Solutions Architect II..,APJ Security Services
16437,Elvin Owens,M,17/07/1986,33,82649,67605,15044,Network Infrastructure Engineer II..,Networks - APJ Infrastructure
8911,Israel Wyatt,M,22/11/1989,30,81824,65442,16382,Hardware Performance Engineer II..,Networks - Technology
16167,Arlen Fox,M,14/06/1985,35,83792,53479,30313,Solutions Architect II..,GSS EPIC CIAM
10659,Tamika Clements,F,1/10/92,27,81934,50598,31336,Technical Project Manager II..,APJ PS - SA/IN
20607,Denver Aguirre,M,6/6/93,27,85426,69439,15987,Software Engineer II..,Media Portal
21419,Otha Rhodes,M,10/12/89,30,85129,71331,13798,Technical Project Manager II..,Web Americas - ECG
10646,Christopher Huff,M,5/1/93,27,83127,46610,36517,Software Engineer.Senior.,Enterprise Applications
15293,Gus Stanley,M,4/9/90,29,82198,55204,26994,Network Infrastructure Engineer II..,Networks - EMEA Infrastructure
9860,Cristopher Church,M,29/03/1990,30,85648,53924,31724,Platform Operations Engineer.Senior.,Platform Operations
17318,Judith Cherry,F,8/8/93,26,82392,62775,19617,Software Development Engineer in Test.Senior.,Media Ghost
16558,Dorsey Shepherd,M,21/02/1991,29,85571,54935,30636,Solutions Architect II..,Service Delivery Americas Media
11332,Adrian Schaefer,F,24/10/1989,30,84040,64668,19372,Solutions Architect II..,Service Delivery EMEA
23048,Bruno Stuart,M,19/09/1984,35,82342,77834,4508,Systems Engineer.Senior.,Developer Productivity
15855,Hallie Wood,F,18/10/1991,28,82944,62778,20166,Software Engineer.Senior.,Corporate Systems
16024,Dewitt Spence,M,8/1/89,31,85284,57980,27304,Solutions Architect II..,GSS EPIC Product Evaluation
17176,Doris Ryan,F,25/06/1991,29,85017,68594,16423,Security Operations Center Specialist..,APJ Security Services - SOCC
21782,Rosalyn Meyers,F,9/11/91,28,84449,61653,22796,Software Engineer II..,Enterprise Applications
10660,Freddie Whitaker,M,3/6/92,28,84786,79485,5301,Software Engineer.Senior Lead.,AmaTec - APS
14610,Darnell Oconnell,M,5/10/90,29,84357,57350,27007,Software Engineer.Senior.,Enterprise Center
10879,Mavis Jackson,F,10/10/87,32,86540,67015,19525,Services Analyst.Senior.,Service Delivery Excellence
16933,Osvaldo Welch,M,16/08/1990,29,83892,43921,39971,Software Engineer.Senior.,GSS EPIC Engineering (HC COGS)
12100,Matt Cain,M,31/10/1988,31,82755,62691,20064,Platform Operations Engineer II.Lead.,Platform Operations
16354,Jerald Best,M,19/02/1983,37,84087,68597,15490,Technical Solutions Engineer II..,AmaTec - Americas TSE
18960,Dane Gaines,M,22/10/1987,32,84266,57259,27007,Solutions Architect II..,Service Delivery Special Projects
16543,Patsy Ferguson,F,29/06/1988,32,84431,58143,26288,Program Manager..Technical,GPO PMO & Business Operations
11625,Valarie Best,F,14/01/1988,32,84786,64852,19934,Relationship Manager..,Media AMER Sales ECG
10661,Shirley Morales,F,29/08/1992,27,86850,70174,16676,Technical Solutions Engineer II..,AmaTec - Americas TSE
15716,Jordon Hunt,M,14/12/1987,32,85119,68635,16484,Solutions Architect II..,Service Delivery EMEA
21881,Phil Hopkins,M,10/10/89,30,86634,65964,20670,Solutions Architect II..,APJ Security Services
15504,Olin Glover,M,1/6/89,31,85304,68923,16381,Software Engineer.Senior.,Enterprise Applications
20963,Raymon Mcintyre,M,22/08/1988,31,85198,69981,15217,Solutions Architect II..,Service Delivery Americas Web
17635,Renato Jarvis,M,20/04/1993,27,84376,64566,19810,Software Engineer.Senior.,Media Ghost
22680,Herman Benson,M,28/08/1990,29,86657,74716,11941,Software Engineer.Senior.,Corporate Systems
20738,Frank Osborn,M,13/05/1990,30,86361,61603,24758,Software Development Engineer in Test.Senior.,Media Analytics
18635,Jed Hamilton,M,11/6/87,33,84303,66256,18047,Program Manager..Technical,CIO Management
21767,Russ Green,M,17/05/1988,32,83568,67793,15775,Solutions Architect II..,Mobile Product
18559,Henrietta Archer,F,13/04/1985,35,84598,39069,45529,Business Systems Analyst.Senior.,Corporate Systems
21501,Colton Hensley,M,27/05/1989,31,86560,70105,16455,Solutions Architect II..,Service Delivery EMEA
22213,Augusta Zimmerman,F,7/10/90,29,85067,67409,17658,Solutions Architect II..,Service Delivery APJ
16990,Corina Copeland,F,14/04/1988,32,87168,68017,19151,Software Development Engineer in Test.Senior.,Dynamic Media SQA
7856,Lydia Byrd,F,24/10/1984,35,86722,68140,18582,Lead..Account Management,Americas- AMG
14036,Karl Oconnor,M,5/6/89,31,87896,67540,20356,Network Delivery Architect II..,Networks - Planning
18367,Jamaal Valenzuela,M,4/1/91,29,85995,38560,47435,Software Engineer.Senior.,Enterprise Applications
18715,Susan Burke,F,24/04/1992,28,88160,73224,14936,Software Development Engineer in Test.Senior.,IT DevOps
7235,Wesley Blackburn,M,6/5/85,35,85996,75498,10498,Order Management Supervisor..,Finance - Customer Revenue Operations G&A
17875,Darell Church,M,9/8/90,29,86015,54888,31127,Software Engineer.Senior.,GSS EPIC Engineering (HC COGS)
14924,Kay Peterson,F,2/12/86,33,85041,55978,29063,Product Operations Analyst.Senior.,IT Product Management & Ops
19915,Corey Hill,M,12/10/87,32,86833,69975,16858,System Operations Engineer.Senior.,Media Experience SQA
21985,Norris Garrett,M,5/5/87,33,86164,53774,32390,Release Engineer.Senior.,Media Analytics
15611,Otis Farley,M,26/12/1983,36,85667,71458,14209,Telecom Engineer II..,Enterprise Infrastructure Services
23026,Dominique Lozano,F,28/05/1991,29,87528,82913,4615,Software Engineer.Senior.,Media Portal
12124,Toby Hanna,M,23/12/1982,37,85153,67803,17350,Recruiter.Senior.,Talent Acquisition
12006,Dionne Mclaughlin,F,17/07/1987,32,87796,60922,26874,Business Systems Analyst.Senior.,Corporate Systems
10119,Joanne Lucas,F,21/05/1990,30,86707,61427,25280,Software Engineer.Senior.,Corporate Systems
8999,Junior Simmons,M,3/11/83,36,88340,60108,28232,Business Operations Analyst.Senior Lead.,Web Division Sales Ops
7324,Francesca Cochran,F,20/11/1990,29,87930,54194,33736,Software Engineer.Senior.,Media Delivery Product Engineering
17109,Frederic Pugh,M,25/10/1987,32,86704,56491,30213,Software Development Engineer in Test.Senior.,Web Performance Engineering
18917,Chauncey Hughes,M,8/8/92,27,87215,52575,34640,Software Engineer II..,Media Analytics
16751,Maryanne Haney,F,22/08/1987,32,88797,58162,30635,Solutions Architect II..,Service Delivery Americas Web
19941,Elise Hubbard,F,30/11/1987,32,87358,52739,34619,Software Development Engineer in Test.Senior Lead.,IT DevOps
22293,Scot Chandler,M,11/4/88,32,88768,64891,23877,Solutions Architect II..,APJ Security Services
22726,Marvin Mcguire,M,18/01/1989,31,85893,59439,26454,Business Operations Analyst.Senior.,Web Strategy
22376,Rex Rodgers,M,8/9/91,28,86500,57887,28613,Software Engineer.Senior.,Dynamic Media SQA
22405,Elisha Wilcox,M,29/09/1986,33,89324,54773,34551,Software Development Engineer in Test.Senior.,Dynamic Media SQA
22771,Eldon Reeves,M,15/02/1984,36,88791,44476,44315,Software Development Engineer in Test.Senior.,Storage Engineering
18793,Eddie Obrien,F,8/11/87,32,85486,67801,17685,Software Development Engineer in Test.Senior Lead.,Media Portal
6048,Orlando Wallace,M,17/03/1980,40,87087,68562,18525,Manager..Contract Management,Finance - Customer Revenue Operations G&A
3753,Emmitt Daniels,M,25/11/1978,41,88922,55762,33160,Platform Operations Engineer II..,Platform Operations
18887,Jamison Norris,M,1/5/87,33,87053,67475,19578,Software Engineer.Senior.,Corporate Systems
15091,Sebastian Oneill,M,4/9/91,28,86197,73625,12572,Solutions Architect II..,Service Delivery APJ
20916,Sherman Pugh,M,14/10/1989,30,87045,72334,14711,Marketing Program Specialist.Senior.,Web APJ Field Marketing
11100,Robby Armstrong,M,14/07/1989,31,88657,74489,14168,Technical Project Manager II..,APJ PS - SA/IN
15819,Berry Trevino,M,31/07/1989,30,86309,75884,10425,Technical Project Manager II..,APJ PS - SA/IN
21871,Matilda Raymond,F,20/08/1991,28,87972,62368,25604,Solutions Architect II..,GSS EPIC CIAM
16999,Nathanial Mckenzie,M,13/07/1988,32,89348,58963,30385,Technical Solutions Engineer II.Lead.,AmaTec - APJ TSE
22179,Alonzo Morse,M,9/11/84,35,89322,73567,15755,Technical Project Manager II..,Web Americas - ECG
19860,Charles Black,M,3/3/81,39,87820,56925,30895,Network Engineer II..,Networks - Technology
11538,Maritza Valenzuela,F,6/12/88,31,86489,63826,22663,Q/A Engineer.Senior II.,IT DevOps
7887,Haywood Cohen,M,18/05/1985,35,88110,58050,30060,Infrastructure Delivery Manager II..,Networks - APJ Infrastructure
17927,Clara Carrillo,F,9/5/92,28,87752,73560,14192,Technical Solutions Engineer II.Lead.,AmaTec - EMEA TSE
20741,Tonya Woodard,F,28/03/1988,32,88741,60503,28238,Q/A Engineer.Senior.,IT DevOps
16733,Stacey Munoz,M,27/09/1986,33,89195,66809,22386,Technical Project Manager II..,APJ Security Services
18795,Abraham Haas,M,7/3/90,30,90048,67974,22074,Software Engineer.Senior.,Media Analytics
20528,Felipe Shepard,M,6/7/81,39,89109,71217,17892,Database Administrator II..,Enterprise Infrastructure Services
16450,Kieth Burch,M,21/07/1992,27,87108,59689,27419,Relationship Manager II..,Media AMER Sales ECG
14482,Jame Brock,M,21/04/1990,30,87277,56511,30766,Systems Support Engineer.Senior.,IT DevOps
17930,Roberta Kemp,F,26/10/1985,34,90205,73125,17080,Solutions Architect II..,Service Delivery APJ
7684,Willard Cochran,M,28/11/1981,38,88412,64111,24301,Technical Project Manager II..,APJ Security Services
20582,Alfredo Alexander,M,18/10/1990,29,89850,69262,20588,Software Engineer II..,GSS EPIC Engineering (HC COGS)
14844,Damion Brown,M,5/8/89,30,90788,57177,33611,Security Operations Center Specialist II..,APJ Security Services - SOCC
7305,Bonnie Odonnell,F,29/06/1988,32,89877,71232,18645,Technical Project Manager II..,APJ PS - SA/IN
20474,Frances Christensen,F,26/10/1992,27,87625,65127,22498,Software Engineer.Senior.,Media Ghost
20191,Samuel Black,M,30/06/1986,34,88930,67755,21175,Systems Administrator II..UNIX,Enterprise Infrastructure Services
7447,Floyd Escobar,M,8/11/86,33,88009,51331,36678,Platform Operations Engineer.Senior Lead.,Platform Operations
18207,Man Woods,M,5/9/88,31,89654,71502,18152,Business Systems Analyst.Senior.,Corporate Systems
16457,Iris Middleton,F,1/3/90,30,91573,75089,16484,Contract/Billing Analyst II..,Finance - Customer Revenue Operations G&A
11440,Guy Woods,M,2/8/88,31,89298,66648,22650,Q/A Engineer.Senior II.,IT DevOps
4359,Kara Sparks,F,19/07/1984,35,88622,61538,27084,Manager..Order Management,Finance - Customer Revenue Operations G&A
18521,Jack Walsh,M,9/1/90,30,90417,59021,31396,Software Development Engineer in Test.Senior.,Media Analytics
10120,Terrance Colon,M,4/1/87,33,91013,77800,13213,Software Engineer.Senior.,Corporate Systems
6273,Gabriel Knapp,M,21/09/1989,30,90145,56895,33250,Business Systems Analyst.Senior.,Enterprise Applications
22189,Emmett Stuart,M,16/11/1987,32,88487,71703,16784,Software Development Engineer in Test.Senior.,Media Services Engineering
22769,Megan Mcneil,F,9/8/91,28,87964,49061,38903,Data Scientist.Senior.,Security Engineering
20473,Dana Hartman,M,15/11/1990,29,89586,63981,25605,Solutions Architect II..,Service Delivery Americas Web
20672,Rickie Logan,M,21/08/1988,31,88603,59093,29510,Solutions Architect II..,Service Delivery Americas Web
16604,Zachariah Montoya,M,29/03/1988,32,90036,58044,31992,Technical Solutions Engineer II..,AmaTec - Americas TSE
12419,Amy Mcconnell,F,15/01/1977,43,88924,56142,32782,Instructional Designer.Senior.,Learning & Development
5782,Jackie Oliver,M,8/4/85,35,92008,65905,26103,Database Administrator II..,Enterprise Infrastructure Services
6404,Raul Sellers,M,2/11/82,37,89702,73001,16701,Business Systems Analyst.Senior.,GSS EPIC Engineering (HC COGS)
17686,Reed Mathews,M,17/05/1981,39,88397,69951,18446,Systems Administrator II..Windows,Enterprise Infrastructure Services
9358,Rafael Weiss,M,7/8/83,36,90366,72977,17389,Lead..Account Management,Americas- AMG
15630,Leopoldo Mata,M,28/09/1988,31,88486,68926,19560,Technical Solutions Engineer II..,AmaTec - Americas TSE
19538,Jaclyn Woodard,F,8/12/90,29,91453,54429,37024,Release Engineer.Senior.,Enterprise Networks
19832,Mac Gutierrez,M,5/5/90,30,90464,60907,29557,Program Manager II..Technical,CIO Management
15612,Jenna Doyle,F,14/07/1984,36,92060,69149,22911,Solutions Architect II..,Service Delivery APJ
17488,Michale Vincent,M,5/5/87,33,92424,63981,28443,Software Development Engineer in Test.Senior.,Storage Engineering
17187,Stefan Banks,M,7/4/81,39,91748,72872,18876,Recruiter.Senior.,Talent Acquisition
1934,Kristin Cooley,F,7/2/78,42,89019,67138,21881,Solutions Architect.Senior II.,Service Delivery Special Projects
18269,Marisol Greer,F,13/02/1987,33,89659,54106,35553,Systems Administrator.Senior Lead.UNIX,Enterprise Infrastructure Services
9877,Josue Jimenez,M,11/12/78,41,89299,70221,19078,Graphic Designer.Senior Lead.,Learning & Development
14299,Elvin Shepard,M,6/7/89,31,90939,66363,24576,Product Operations Analyst.Senior.,Web Strategy
19890,Elijah Duncan,M,10/10/89,30,92190,72378,19812,Software Engineer.Senior.,Media Ghost
18921,Owen Barajas,M,28/11/1989,30,90821,72082,18739,Software Engineer.Senior.,Media Analytics
22820,Carrol Serrano,M,23/09/1993,26,92666,66347,26319,Software Engineer II..,Media Portal
22252,Mauricio Donovan,M,13/03/1992,28,93178,56348,36830,Software Engineer.Senior.,Media Analytics
18961,Davis Herrera,M,26/08/1990,29,93283,55225,38058,Software Engineer II..,LUNA/OPEN Engineering
17980,Fernando Leonard,M,11/8/88,31,93373,73980,19393,Software Engineer.Senior.,Media Analytics
7863,Elton Morse,M,31/12/1982,37,93214,70792,22422,Business Operations Analyst.Senior.,Media Division Sales Ops
10107,Eli Glenn,M,21/02/1983,37,90694,70981,19713,LMS Administrator.Senior Lead.,Learning & Development
18888,Booker Hensley,M,23/11/1989,30,91614,68672,22942,Software Engineer.Senior.,GSS EPIC Engineering (HC COGS)
18590,Fernando Baldwin,M,25/06/1985,35,92265,57937,34328,Software Engineer.Senior.,Corporate Systems
22288,Forest Pruitt,M,16/11/1992,27,91365,71062,20303,Security Operations Center Specialist II..,APJ Security Services - SOCC
14834,Everett Short,M,20/12/1989,30,93572,64271,29301,Technical Solutions Engineer II.Lead.,AmaTec - Americas TSE
20671,Howard Livingston,M,9/6/91,29,90432,65449,24983,Solutions Architect II..,Service Delivery Americas Web
3395,Ulysses Barajas,M,4/6/79,41,90679,57627,33052,Shift Manager..Platform Operations,Platform Operations
17669,Scott Perez,M,30/08/1988,31,92845,55685,37160,Software Development Engineer in Test.Senior.,Web Performance Engineering
21692,Angeline Freeman,F,5/10/91,28,93264,75441,17823,Security Operations Center Specialist II..,APJ Security Services - SOCC
21664,Tyrell Hall,M,14/07/1988,32,92015,59391,32624,Security Operations Center Specialist II..,APJ Security Services - SOCC
8381,Antonia Mclean,M,29/07/1990,29,90488,60402,30086,Platform Operations Engineer.Senior.,Platform Operations
4583,Frankie Mays,M,3/2/79,41,93368,56762,36606,Accountant.Senior Lead.,Finance - Accounting
16513,Jerry Frey,F,6/3/86,34,91209,71779,19430,Deal Desk Analyst.Senior.,Finance - Customer Revenue Operations S&M
19969,Dale Doyle,M,14/11/1989,30,92045,56810,35235,Solutions Architect II.Lead.,Service Delivery DPM
21971,Tamera Boyd,F,3/6/91,29,93248,60330,32918,Solutions Architect II..,GSS EPIC CIAM
5157,Jacinto Stein,M,2/5/81,39,93139,58876,34263,Revenue Accountant.Senior Lead.,Finance - Accounting
17971,Shannon Salazar,M,26/01/1981,39,94816,64559,30257,Solutions Architect II..,Mobile Product
6426,Lee Park,M,21/08/1986,33,92916,57126,35790,Manager..Contract Management,Finance - Customer Revenue Operations G&A
14630,Cameron Durham,M,28/02/1984,36,94417,60393,34024,Business Operations Analyst.Senior.,Media Division Sales Ops
16411,Fritz Rivers,M,19/05/1991,29,91049,54196,36853,Systems Support Engineer.Senior Lead.,Developer Productivity
16521,Hung Bryant,M,29/06/1992,28,91317,54496,36821,Technical Solutions Engineer II..,AmaTec - CIAM
10343,Elwood Cantu,M,12/3/87,33,92651,61546,31105,Q/A Engineer.Senior II.,IT DevOps
22679,Lynnette Morgan,F,9/10/92,27,95147,80892,14255,Security Operations Center Specialist II..,APJ Security Services - SOCC
11994,Ophelia Osborne,F,5/10/89,30,95204,70079,25125,Shift Manager..Platform Operations,Platform Operations
14585,Aaron Reyes,M,16/12/1993,26,94784,58134,36650,Software Engineer.Senior.,Platform Mapping Engineering
22788,Herman Hester,M,9/9/82,37,95033,75601,19432,Business Operations Analyst.Senior.,Web Division Sales Ops
22709,Otto Sweeney,M,27/09/1986,33,94559,68711,25848,Business Systems Analyst.Senior.,Corporate Systems
20889,Andreas Caldwell,M,21/06/1990,30,93705,43466,50239,Software Development Engineer in Test.Senior.,Media Services Engineering
12060,Cleveland Cisneros,M,24/03/1988,32,92859,58504,34355,Technical Solutions Engineer II.Lead.,AmaTec - APJ TSE
21133,Terrie Curry,F,29/12/1988,31,93802,62022,31780,Q/A Engineer.Senior.,Enterprise Networks
17102,John Dunn,M,21/09/1991,28,95167,75599,19568,Security Operations Center Specialist II..,APJ Security Services - SOCC
16724,Jacques Sparks,M,21/06/1989,31,93770,59765,34005,Solutions Architect II..,Service Delivery Americas Web
10418,Brad Klein,M,5/6/80,40,94252,78950,15302,Business Systems Analyst.Senior.,Corporate Systems
5005,Kurt Cortez,M,9/9/83,36,93517,70642,22875,Manager..Collections,Finance - Customer Revenue Operations G&A
17132,Arron Figueroa,M,22/08/1988,31,93930,60484,33446,Solutions Architect II..,Service Delivery Americas Media
15049,Erasmo Bird,M,19/05/1982,38,93779,58092,35687,Software Engineer II..,Corporate Systems
18267,Dion Velez,M,8/12/86,33,93886,65257,28629,Software Engineer.Senior.,LUNA/OPEN Engineering
6258,Carl Waters,M,3/1/77,43,93255,76961,16294,User Interface Engineer.Senior.,AmaTec - APS
11998,Neil Finley,M,12/12/85,34,95096,61360,33736,Systems Support Engineer.Senior.,IT DevOps
10732,Tom Sampson,M,16/03/1988,32,94002,74589,19413,Software Engineer.Senior.,Enterprise Applications
21630,Cliff Holland,M,30/09/1988,31,93338,73047,20291,Solutions Architect II..,Service Delivery Americas Web
19022,Elmer Marshall,M,17/10/1988,31,93950,72584,21366,Software Engineer.Senior.,GSS EPIC Engineering (HC COGS)
20082,Coy Shepherd,M,8/12/91,28,95680,71383,24297,Software Development Engineer in Test.Senior.,Media Ghost
4057,Moises Cummings,M,28/09/1980,39,95455,65687,29768,Technical Solutions Engineer.Senior Lead.,AmaTec - Americas TSE
5785,Petra Silva,F,5/3/86,34,93456,71244,22212,Business Operations Analyst.Senior Lead.,Marketing - Operations
17276,Roosevelt Nguyen,M,23/08/1991,28,94760,61353,33407,Technical Solutions Engineer II.Lead.,AmaTec - Americas TSE
11347,Armand Avery,M,30/08/1979,40,96118,76515,19603,Financial Analyst.Senior.,Web Division Finance
18727,Fredric Oneal,M,11/11/89,30,96371,55087,41284,Software Engineer.Senior.,Corporate Systems
9826,Dominic Knapp,M,19/02/1987,33,96301,55356,40945,Q/A Engineer.Senior II Lead.,IT DevOps
22180,Ned Roth,M,25/04/1991,29,94822,65118,29704,Software Development Engineer in Test.Senior.,Media Services Engineering
7711,Jarrod Meyers,M,25/02/1991,29,94156,54610,39546,Performance Engineer II..,Product - Custom
18555,Tristan Farmer,M,3/4/90,30,94203,73271,20932,Release Engineer.Senior.,LUNA/OPEN Engineering
17977,Denver Vance,M,24/08/1987,32,97008,55525,41483,Business Systems Analyst.Senior II.,Corporate Systems
4909,Jacob Fields,M,22/09/1984,35,96939,60043,36896,Network Delivery Architect II..,Networks - Planning
11673,Celina Larsen,F,1/10/88,31,96843,79904,16939,Program Manager II..,GSS Global Programs
11623,Savannah Ferrell,F,24/12/1988,31,95505,58723,36782,Q/A Engineer.Senior II.,IT DevOps
16296,Gerard Roth,M,24/06/1985,35,97107,68148,28959,Release Engineer.Senior Lead.,IT DevOps
19731,Reba Evans,F,26/11/1991,28,95888,74636,21252,Software Engineer.Senior.,LUNA/OPEN Engineering
19398,Liz Byrd,F,5/12/90,29,95487,64002,31485,Business Systems Analyst.Senior.,Enterprise Applications
18922,Abigail Price,F,29/12/1983,36,96116,80094,16022,Client Service Manager..,Americas- AMG
15402,Edward Ray,M,17/07/1982,37,96710,58121,38589,Technical Project Manager II..,Core East - PS
19843,Rodney Frank,M,22/05/1986,34,96183,61578,34605,Business Systems Analyst.Senior.,Corporate Systems
15057,Katelyn Hubbard,F,14/12/1991,28,95437,65641,29796,Technical Solutions Engineer II..,AmaTec - APJ TSE
22845,Beau Bryant,M,24/07/1987,32,95068,65681,29387,Business Systems Analyst.Senior II.,Corporate Systems
5096,Geneva Buckley,F,17/07/1983,36,97890,66912,30978,Q/A Engineer.Senior II Lead.,IT DevOps
17663,Casandra Tapia,F,3/6/71,49,97023,74829,22194,Documentation and Training Specialist.Senior.,Engineering Learning
20088,Emile Key,M,25/08/1991,28,96534,72623,23911,Software Engineer.Senior.,Security Engineering
20119,Arden Farley,M,20/04/1991,29,98651,75072,23579,Security Operations Center Specialist II..,APJ Security Services - SOCC
19090,Jeff Anthony,M,10/2/89,31,97908,37087,60821,Business Systems Analyst.Senior II.,Corporate Systems
9965,Anibal Douglas,M,30/08/1987,32,97195,77043,20152,Business Systems Analyst.Senior.,Corporate Systems
11223,Jerrold Weeks,M,10/11/87,32,96244,45627,50617,Software Engineer.Senior.,Enterprise Networks
20957,Antwan Zimmerman,M,13/06/1991,29,98367,59008,39359,Data Engineer.Senior.,Data Engineering Analytics & Intelligence
19859,Cliff Barrett,M,1/7/84,36,98748,69323,29425,Business Systems Analyst.Senior II.,Enterprise Applications
22447,Earnest Park,M,20/06/1991,29,96891,82494,14397,Security Operations Center Specialist II..,APJ Security Services - SOCC
22360,Olga Miranda,F,16/12/1990,29,98256,78185,20071,Customer Incident Manager..,AmaTec - Incident Mgmt
4422,Tiffany Booker,F,26/08/1968,51,96940,59732,37208,Technical Writer.Senior II.,LUNA User Experience Design
21069,Buford Guerra,M,12/9/90,29,97372,66368,31004,Software Engineer.Senior.,Enterprise Applications
18469,Clyde Heath,M,2/3/89,31,96357,74662,21695,Software Engineer.Senior.,LUNA/OPEN Engineering
22844,Eli Gibbs,M,18/04/1992,28,99008,82960,16048,System Operations Engineer.Senior.,Enterprise Access Engineering
15556,Andre Moses,M,17/11/1983,36,98579,63490,35089,Software Development Engineer in Test.Senior II.,Media Analytics
7599,Meredith Gaines,F,25/03/1982,38,98405,76410,21995,Technical Enablement Strategist..,GSS Technical Enablement
11045,Tameka Alexander,F,4/2/89,31,97126,60666,36460,Q/A Engineer.Senior II.,IT DevOps
18696,Erick Jackson,M,3/3/87,33,99328,74910,24418,Technical Account Manager II..,Acquisitions - ECG IAE Pre-Sales
11933,Elias Dorsey,M,22/12/1988,31,96436,45859,50577,Platform Operations Engineer.Senior.,Platform Operations
6236,Ahmad Gross,M,9/8/84,35,96562,72790,23772,Technical Solutions Engineer.Senior.,AmaTec - Weekend TSE
16332,Steve Swanson,M,23/03/1992,28,98911,72554,26357,Platform Operations Engineer II..,Platform Operations - Custom
16591,Edgardo Landry,M,24/09/1984,35,98298,67230,31068,Network Delivery Architect II..,Networks - Planning
10897,Richard Allen,M,1/3/85,35,96897,78432,18465,Q/A Engineer.Senior II.,IT DevOps
21091,Quincy Santos,M,30/08/1987,32,97938,78205,19733,Technical Account Manager II..,Acquisitions - ECG IAE Pre-Sales
4778,Blake Choi,M,7/9/78,41,97137,67566,29571,Manager..Booking Operations,Financial Planning and Analysis
17641,Vivian Ross,F,26/11/1993,26,100195,74884,25311,Product Support Engineer..,Enterprise Networks
16535,Wilburn Salinas,M,25/10/1989,30,99712,67204,32508,Security Operations Center Specialist II..,APJ Security Services - SOCC
11999,Noah Wells,M,23/08/1990,29,99998,61123,38875,Software Engineer.Senior.,Enterprise Networks
15818,Caleb Rivera,M,21/06/1988,32,100065,63446,36619,Platform Operations Engineer II..,Platform Operations
6125,Sherman Barton,M,9/8/82,37,97025,60714,36311,Manager..Contract Management,Finance - Customer Revenue Operations G&A
14323,Claude Moore,M,28/07/1986,33,99648,62630,37018,Systems Support Engineer.Senior.,Media Reliability Engineering
16421,Josue Ramos,M,27/12/1989,30,100415,64910,35505,Software Engineer.Senior.,Corporate Systems
15354,Jae Montoya,M,8/4/83,37,100456,79332,21124,User Interface Engineer.Senior.,GSS EPIC Engineering (HC COGS)
4760,George Weeks,M,20/06/1984,36,98064,71413,26651,Manager..Finance,Web Division Finance
14635,Minh Blackwell,M,5/1/89,31,99640,68226,31414,Technical Solutions Engineer II..,AmaTec - APJ TSE
17835,Marcellus Trujillo,M,25/02/1974,46,98622,72908,25714,Documentation and Training Specialist.Senior.,Engineering Learning
19007,Winford Carney,M,11/10/90,29,98682,47905,50777,Business Operations Analyst.Senior Lead.,Web Strategy
19858,Rusty Weber,M,3/8/90,29,99527,59192,40335,Business Systems Analyst.Senior.,Corporate Systems
22971,Celeste Stanton,F,20/01/1986,34,100038,94501,5537,Software Development Engineer in Test II..,APJ Security Services
9373,Rod Andrews,M,16/08/1989,30,99645,75302,24343,Technical Project Manager II..,APJ PS - SA/IN
6095,Dong Forbes,M,1/6/84,36,99193,51835,47358,Software Development Engineer in Test.Senior.,Dynamic Media SQA
11840,Tisha Mckenzie,F,16/02/1987,33,100179,74979,25200,Relationship Manager..,Media AMER Sales ECG
9870,Carolyn Zuniga,F,4/5/87,33,100143,69815,30328,Financial Analyst.Senior.,Media Division Finance
4033,Stanton Fleming,M,3/3/83,37,98472,68849,29623,Manager..Account Management,APJ - AMG
8134,Delmer Andrews,M,3/11/91,28,101269,64558,36711,Software Engineer.Senior.,Media Portal
17926,Wade Kramer,M,10/6/85,35,101693,81208,20485,Software Development Engineer in Test.Senior.,Web Performance Engineering
10671,Scott Brewer,M,20/09/1991,28,101266,62579,38687,Reliability Engineer.Senior.,Technology
19019,Jim Greer,M,14/04/1989,31,99710,49613,50097,Business Systems Analyst.Senior II.,Corporate Systems
19675,Clement Cunningham,M,22/05/1989,31,99994,61330,38664,Software Development Engineer in Test.Senior Lead.,Platform Mapping Engineering
19161,Freddy Blankenship,M,24/11/1986,33,100939,61163,39776,Software Engineer.Senior.,AmaTec - APS
10733,Myrtle Gamble,F,25/07/1988,31,100044,65420,34624,Software Engineer.Senior II.,Enterprise Applications
7445,Rupert Wolf,M,4/12/87,32,101279,65900,35379,Software Engineer.Senior.,Media Portal
17404,Hector Curtis,M,7/4/89,31,99392,74430,24962,Software Engineer.Senior.,Web Performance Engineering
20360,Alvaro Franklin,M,26/10/1986,33,101286,79092,22194,Technical Solutions Engineer II..,AmaTec - APJ TSE
19703,Olin Farmer,M,4/5/88,32,98743,69920,28823,Web Developer.Senior.,Marketing - Technical Marketing
19193,Stacey Robertson,M,2/8/92,27,101799,78563,23236,Software Engineer II..,GSS EPIC Engineering (HC COGS)
14300,Summer Nielsen,F,15/08/1982,37,100036,35820,64216,Human Resources Business Partner II..,International - Business Partners
3914,Cassie Aguirre,F,17/03/1980,40,101211,82190,19021,Program Manager II..,Marketing - Technical Marketing
16514,Minerva Mcclain,F,4/2/88,32,100663,73214,27449,Technical Solutions Engineer II.Lead.,AmaTec - Americas TSE
21855,Adolph Fitzpatrick,M,4/2/88,32,100992,55011,45981,Software Engineer.Senior.,Media Portal
9857,Teodoro Foster,M,10/12/89,30,100426,77791,22635,Platform Operations Engineer II.Lead.,Platform Operations - Custom
20077,Marvin Lambert,M,11/9/92,27,101087,79110,21977,Support Delivery Specialist..,AmaTec - SDM
8335,Otis Good,M,1/1/78,42,100315,79731,20584,Client Service Manager.Senior.,Americas- AMG
15301,Dana Gregory,M,29/09/1986,33,103021,81326,21695,Technical Project Manager II..,Web Americas - ECG
6596,Dorthy White,F,20/02/1989,31,99546,77632,21914,Network Infrastructure Engineer.Senior Lead.,Networks - EMEA Infrastructure
8234,Waldo Booker,M,14/06/1981,39,100250,73325,26925,Financial Analyst.Senior Lead.,Web Division Finance
6294,Bernie Greene,M,25/09/1989,30,101652,68117,33535,Systems Support Engineer.Senior II Lead.,Media Reliability Engineering
17880,Vincenzo Santos,M,2/6/85,35,102604,66245,36359,Software Engineer.Senior.,Corporate Systems
22399,Rene Melendez,M,22/08/1990,29,103230,65487,37743,Software Engineer.Senior.,Corporate Systems
22446,Trinidad Meza,M,15/11/1989,30,101376,77493,23883,Security Operations Center Specialist II..,APJ Security Services - SOCC
5095,Evan Mooney,M,19/06/1984,36,101488,63305,38183,Manager..Account Management,Americas- AMG
16459,Rosa Hubbard,F,26/10/1990,29,101849,75735,26114,Product Support Engineer..,AmaTec - PSG
17179,Jackson Arnold,M,3/12/89,30,100606,61214,39392,Software Engineer.Senior.,Media Delivery Product Engineering
22017,Ernie Dalton,M,8/12/89,30,102922,70466,32456,Software Engineer.Senior.,Enterprise Access Engineering
9001,Bo Shepherd,M,11/10/88,31,103759,79170,24589,Manager..Enterprise Security Operations,Enterprise Architecture and Security
18764,Audrey Newton,F,26/05/1988,32,101750,81416,20334,Program Manager II..Technical,Program Management
12351,Troy Joyce,M,29/01/1991,29,102625,67107,35518,Product Support Engineer..,AmaTec - PSG
14752,Desmond Hendrix,M,5/9/90,29,102413,43244,59169,Software Development Engineer in Test.Senior II.,Media Portal
15386,Monica Moreno,F,23/05/1993,27,101049,66620,34429,Platform Operations Engineer II..,Platform Operations - Custom
18618,Otto Hogan,M,25/08/1989,30,101785,79168,22617,Solutions Architect II..,GSS EPIC GCS SDK
22309,Micah Wise,M,1/8/87,32,103095,79543,23552,Software Engineer.Senior.,Corporate Systems
22859,Carlton Ochoa,M,28/05/1989,31,102617,73794,28823,Software Engineer.Senior.,Media Analytics
19208,Maura Barber,F,1/5/84,36,102536,75211,27325,Software Development Engineer in Test.Senior II Lead.,Media Portal
21772,Stewart Ballard,M,30/09/1992,27,101867,77600,24267,Software Engineer.Senior.,IT DevOps
20368,Valeria Schultz,F,3/11/87,32,102939,65902,37037,Software Engineer.Senior.,Corporate Systems
22782,Deandre Francis,M,2/12/87,32,104659,71436,33223,Software Engineer.Senior.,Enterprise Applications
22821,Gilberto Obrien,M,25/03/1991,29,104410,69376,35034,Software Engineer.Senior.,Enterprise Networks
8266,Annmarie Garcia,F,25/08/1978,41,105127,77264,27863,Instructional Designer.Senior.,Learning & Development
5987,Pete Miller,M,27/09/1987,32,104606,79309,25297,Systems Administrator.Senior.Windows,Enterprise Infrastructure Services
6055,Cyril Hoffman,M,11/2/88,32,104189,79367,24822,Web Developer.Senior Lead.,Marketing - Technical Marketing
21822,Anibal Velazquez,M,15/05/1990,30,104539,61220,43319,Software Engineer.Senior.,Enterprise Applications
18898,Darren Marsh,M,24/03/1990,30,103968,67606,36362,Software Engineer.Senior.,Media Services Engineering
23000,Katina Duran,F,11/8/91,28,104049,98096,5953,Software Development Engineer in Test.Senior.,Enterprise Access Engineering
8433,Genevieve Cooper,F,25/12/1985,34,102807,72873,29934,Program Manager.Senior.Technical,CIO Management
22285,Mike Potter,M,15/01/1991,29,103892,68105,35787,Software Engineer.Senior.,Enterprise Applications
19160,Tyrone Charles,M,24/08/1985,34,104028,79245,24783,Manager..Network Infrastructure,Networks - APJ Infrastructure
16520,Paris Mahoney,M,16/09/1989,30,105893,70108,35785,Software Engineer.Senior.,App Architecture & Integration Services
20359,Wm Castaneda,M,10/8/90,29,105793,62543,43250,Q/A Engineer.Senior.,Enterprise Access Engineering
16456,Alan Leblanc,M,16/05/1981,39,104766,76726,28040,Media Operations Engineer.Senior.,Amatec - BOCC/EMM
9325,Dino Walton,M,27/02/1987,33,105227,84285,20942,System Operations Engineer.Senior Lead.,Media Reliability Engineering
4694,Eusebio Reyes,M,14/07/1983,37,105895,69606,36289,Process & Quality Engineer.Senior Lead.,Platform Operations
16943,Augustus Gardner,M,1/8/85,34,105727,55908,49819,Software Engineer.Senior.,Corporate Systems
14371,Sheldon Pacheco,M,27/07/1988,31,106224,77804,28420,Performance Engineer.Senior.,Technology
22456,Reid Gordon,M,6/6/90,30,106163,87231,18932,Site Reliability Engineer.Senior.,Security Engineering
21970,Toni Blake,F,1/3/86,34,104537,64808,39729,Counsel..,Legal
8588,Virgil Herrera,M,9/6/88,32,103020,77962,25058,Web Developer.Senior Lead.,Marketing - Website Management
6374,Cletus Burns,M,13/07/1982,38,103100,71519,31581,Deal Desk Analyst.Senior.,Finance - Customer Revenue Operations S&M
7583,Gayle Baker,F,29/09/1986,33,103798,77782,26016,Network Delivery Architect.Senior.,Networks - Planning
9848,June Nolan,F,29/01/1987,33,104248,72653,31595,Program Manager.Senior.,Service Delivery Americas Web
17821,Dorian Walters,M,25/12/1979,40,106099,68071,38028,Applications Developer.Senior.,Corporate Systems
14774,Jerry Duncan,M,2/10/93,26,105543,70791,34752,Platform Operations Engineer II..,Platform Operations - Custom
15001,Myles Mccarty,M,9/6/90,30,104186,62305,41881,Security Operations Center Specialist II..,APJ Security Services - SOCC
17442,Jacinto Arellano,M,19/05/1989,31,106132,81745,24387,Software Development Engineer in Test.Senior Lead.,Web Shared Engineering - Performance
22069,Jefferson Schaefer,M,14/04/1989,31,107199,65379,41820,Software Engineer.Senior.,Media Portal
8135,Nita Franklin,F,3/8/91,28,104392,83121,21271,Software Engineer.Senior II.,Enterprise Applications
5591,Gilberto Zuniga,M,17/07/1981,38,105370,62966,42404,Manager..Account Management,EMEA - AMG
7267,Gerry Huber,M,4/6/86,34,107255,82347,24908,Systems Administrator.Senior.UNIX,Enterprise Infrastructure Services
22750,Long Forbes,M,2/1/93,27,104930,72098,32832,Data Scientist.Senior.,Security Engineering
7857,Daron Andersen,M,6/2/81,39,104139,77372,26767,Marketing Program Manager..,Campaign Planning
16718,Kyle Castillo,M,25/08/1986,33,104731,52869,51862,Software Engineer.Senior.,Enterprise Access Engineering
14215,Sterling Huffman,M,12/2/89,31,105872,51964,53908,Platform Operations Engineer.Senior.,Platform Operations
18543,Rodolfo Holder,M,6/11/87,32,104466,63287,41179,Reliability Engineer.Senior.,Technology
20647,Guillermo Barr,M,29/08/1989,30,107597,68970,38627,Software Engineer.Senior.,Enterprise Access Engineering
18923,Raleigh Marks,M,19/12/1985,34,108325,43631,64694,Relationship Manager II..,Web Americas Inside Sales East
7506,Geoffrey Burns,M,28/06/1978,42,105269,79588,25681,Q/A Engineer.Senior II.,IT DevOps
4410,Emmett Roberts,M,9/3/82,38,108458,65603,42855,Platform Operations Engineer.Senior Lead.,Platform Operations
7946,Ralph Thomas,M,3/2/90,30,105709,47248,58461,Systems Support Engineer.Senior II Lead.,IT DevOps
18360,Jere Nolan,M,21/09/1985,34,107780,79031,28749,Security Operations Center Specialist.Senior.,APJ Security Services - SOCC
10665,Robin Carey,M,10/10/92,27,105320,68217,37103,Product Support Engineer..,AmaTec - PSG
20257,Chase Harvey,M,29/09/1985,34,105820,96321,9499,Business Systems Analyst.Senior.,Marketplace Product Management
2809,Lessie Donovan,F,11/10/75,44,107362,78747,28615,Manager..Travel and Vendor Management,Global Procurement
7503,Therese Washington,F,24/12/1979,40,106136,69806,36330,Program Manager II..,Wizards Program
18619,Eric Harrell,M,22/05/1988,32,105914,69003,36911,Software Development Engineer in Test.Senior.,DPM Engineering
22846,Trinidad Montoya,M,1/1/90,30,105886,63188,42698,Q/A Engineer.Senior.,Enterprise Networks
22843,Bruce Stout,M,5/2/91,29,105375,73203,32172,Software Engineer.Senior.,Enterprise Access Engineering
10138,Mac Kelley,M,25/04/1989,31,106665,73186,33479,Solutions Architect.Senior.,Service Delivery APJ
7860,Kermit Reilly,M,6/10/88,31,106406,64967,41439,Platform Operations Engineer.Senior.,Platform Operations
7025,Douglas Donaldson,M,9/7/87,33,107718,84769,22949,Solutions Architect.Senior Lead.,GSS EPIC Product Evaluation
8894,Cornelia Fleming,F,24/04/1984,36,109716,90952,18764,Q/A Engineer.Senior II.,IT DevOps
15827,Cristobal Howe,M,23/05/1984,36,108693,63074,45619,Q/A Engineer.Senior II.,IT DevOps
14824,Mario Fernandez,M,20/04/1986,34,108822,83787,25035,Program Manager.Senior.Technical,CIO Management
21017,Todd Wallace,M,10/4/87,33,106486,72849,33637,Software Development Engineer in Test.Senior II.,Media Experience SQA
6867,Cletus Hines,M,8/10/87,32,109043,85089,23954,Product Support Engineer..,AmaTec - PSG
15008,Mickey Farley,M,26/07/1987,32,109019,80121,28898,Software Engineer.Senior II.,Enterprise Applications
8787,Ola Foley,F,13/08/1991,28,107141,72021,35120,Solutions Architect.Senior.,Service Delivery Americas Web
19506,Sadie Wise,F,25/02/1990,30,110098,71716,38382,Software Engineer.Senior.,Corporate Systems
5953,Pat Malone,M,5/3/81,39,110656,84645,26011,Applications Developer.Senior.,Marketing - Website Management
16522,Hilton Copeland,M,10/6/85,35,110309,72549,37760,Software Engineer.Senior II.,Corporate Systems
5713,Javier Andersen,M,10/11/77,42,110423,84935,25488,Q/A Engineer.Senior II.,IT DevOps
9942,Thaddeus Barrett,M,3/7/83,37,111766,87383,24383,Q/A Engineer.Senior II.,IT DevOps
16978,Mohammad Estes,M,13/06/1980,40,107976,78417,29559,Reliability Engineer.Senior.,Technology
16141,Reynaldo Solomon,M,5/11/85,34,108532,79309,29223,Service Architect II..,GSS Service Enablement
19068,Darron Moore,M,9/8/93,26,110204,55531,54673,Software Engineer.Senior.,Enterprise Applications
12023,Janice Hickman,F,25/04/1988,32,109342,73878,35464,Software Engineer.Senior II.,Enterprise Applications
8180,Rickey Marquez,M,28/01/1981,39,110720,46157,64563,Deal Desk Analyst.Senior Lead.,Finance - Customer Revenue Operations S&M
17417,Chris Baird,M,25/01/1979,41,109764,80426,29338,Recruiter.Senior Lead.,Talent Acquisition
10118,Helena Ayers,F,21/03/1991,29,109403,67908,41495,Software Engineer.Senior II.,Corporate Systems
8360,Jere Middleton,M,12/11/89,30,110719,66051,44668,Engagement Manager II..,APJ EM - SA/IN
11024,Elvis Gaines,M,27/02/1989,31,108833,67748,41085,Software Engineer.Senior.,Corporate Systems
8942,Giuseppe Davies,M,18/05/1987,33,110971,84186,26785,Applications Developer.Senior.,Marketing - Technical Marketing
19905,Loren Shea,M,22/07/1988,31,110886,68057,42829,Software Development Engineer in Test.Senior II.,Dynamic Media SQA
15205,Hank Osborne,M,4/7/86,34,112431,87904,24527,Software Development Engineer in Test.Senior.,Media Experience SQA
7683,Armando Velasquez,M,12/5/83,37,109299,65574,43725,Software Development Engineer in Test.Senior II.,Media Analytics
15294,Lemuel Noble,M,20/08/1985,34,111453,46534,64919,Software Engineer.Senior II.,Enterprise Applications
8450,Rupert Small,M,27/03/1986,34,112720,48509,64211,Incident Manager..,Platform Operations
21058,Cedrick Sampson,M,28/08/1989,30,111603,81725,29878,Relationship Manager..,Web Americas Field East
19119,Gerard Fischer,M,22/10/1977,42,110498,85689,24809,Systems Administrator.Senior Lead.Windows,Enterprise Infrastructure Services
17310,Jospeh Arellano,M,14/11/1984,35,111383,52867,58516,Software Engineer.Senior II.,Corporate Systems
16360,Tristan Briggs,M,11/1/87,33,109943,66993,42950,Software Engineer.Senior II.,App Architecture & Integration Services
7418,Domingo Pruitt,M,26/11/1986,33,110849,84122,26727,Manager..Network Infrastructure,Networks - APJ Infrastructure
8328,Jamey Leach,M,5/2/80,40,110414,46441,63973,Supervisor..Help Desk,Enterprise Infrastructure Services
21131,Ervin Roach,M,9/7/89,31,113423,61551,51872,Software Engineer.Senior.,Media Ghost
8613,Rodolfo Guzman,M,17/05/1983,37,111359,73462,37897,Software Engineer.Senior II Lead.,Enterprise Applications
20759,Roseann Nguyen,F,11/11/90,29,112905,85481,27424,Technical Consultant II..,Media AMER PreSales Inside Sales & ECG
19006,Gerard Dominguez,M,20/01/1987,33,114069,77486,36583,Software Development Engineer in Test.Senior II.,Dynamic Media SQA
22689,Angie Norton,F,9/8/90,29,110541,63798,46743,Software Engineer.Senior.,Corporate Systems
19778,Jonathan Spencer,M,30/04/1985,35,112584,82513,30071,Solutions Engineer II..,APJ Enterprise Pre-Sales
18767,Jeramy Rivera,M,25/11/1983,36,111597,67882,43715,Software Engineer.Senior II.,Media Portal
16142,Joesph Mcguire,M,24/05/1989,31,112976,86468,26508,Manager..Technical Support,AmaTec - Mgmt
11931,Mel Jones,M,24/06/1988,32,112389,71879,40510,Shift Manager..Platform Operations,Platform Operations
8778,Jean Ferrell,M,23/06/1991,29,113006,55183,57823,Software Engineer.Senior II.,Enterprise Applications
11947,Antonio Flynn,M,19/09/1989,30,113667,75037,38630,Q/A Engineer.Senior II.,IT DevOps
8714,Donnie Hartman,M,7/7/87,33,110567,49299,61268,Business Systems Analyst.Senior II.,Marketplace Product Management
6380,Carlton Prince,M,24/10/1981,38,114256,75144,39112,Manager..Sales Operations,Web Division Sales Ops
12344,Dirk Friedman,M,28/07/1986,33,112172,68788,43384,Software Engineer.Senior II.,Enterprise Networks
8392,Kasey Holt,M,26/08/1987,32,114597,82485,32112,Manager..Account Management,Americas- AMG
16209,Jesse Hooper,M,19/06/1985,35,111484,87926,23558,Solutions Architect.Senior.,Service Delivery Americas Web
7851,Lynwood Sexton,M,16/07/1988,31,112172,70354,41818,Software Engineer.Senior II.,Corporate Systems
15393,Alexander Galvan,M,17/06/1988,32,111658,55200,56458,Software Engineer.Senior II.,Enterprise Access Engineering
9886,Raquel Velasquez,F,21/01/1982,38,114356,82928,31428,Manager..Q/A Engineering,IT DevOps
18273,Harrison Mckenzie,M,7/2/85,35,111943,86497,25446,Software Development Engineer in Test.Senior II.,Developer Productivity
4772,Genaro Moon,M,23/03/1983,37,112737,56000,56737,Performance Engineer.Senior II Lead.,Product - Custom
14900,Bret Rubio,M,25/04/1983,37,112686,70764,41922,Software Development Engineer in Test.Senior II.,Security Engineering
22816,Damian Molina,M,23/08/1990,29,112588,86399,26189,Software Engineer.Senior.,Security Engineering
20117,Marlon Russell,M,17/10/1992,27,113313,72216,41097,Support Delivery Specialist..,AmaTec - SDM
22973,Clifton Alvarado,M,28/10/1992,27,112920,106588,6332,Applications Developer II..,Corporate Systems
5612,Rod Wiggins,M,9/12/82,37,114490,74447,40043,Program Manager.Senior Lead.,APJ Services Mgmt
16094,Benjamin Hess,M,10/11/89,30,113578,70117,43461,Software Development Engineer in Test.Senior II.,Security Engineering
15004,Philip Bird,M,18/04/1987,33,113576,64128,49448,Security Operations Center Specialist.Senior.,APJ Security Services
16409,Jefferson Romero,M,1/5/90,30,112685,87102,25583,Technical Project Manager.Senior.,Finance Services PS
22838,Carlos Reilly,M,12/6/91,29,112682,78315,34367,Software Development Engineer in Test.Senior.,Security Engineering
20210,Carroll Moran,M,30/08/1987,32,112639,64213,48426,Q/A Engineer.Senior.,Enterprise Access Engineering
17975,Cristopher Anthony,M,20/10/1990,29,114711,55855,58856,Security Operations Center Specialist.Senior.,APJ Security Services - SOCC
11755,Milton Cline,M,5/4/90,30,113271,69771,43500,Shift Manager..Platform Operations,Platform Operations
20544,Maynard Maddox,M,6/7/78,42,115750,43665,72085,Manager..Technical Support,AmaTec - Mgmt
15325,Darren Callahan,M,15/04/1987,33,116170,100803,15367,Software Engineer.Senior II.,Corporate Systems
5224,Annie Maynard,F,29/11/1983,36,114729,86855,27874,Software Development Engineer in Test.Senior II.,Dynamic Media SQA
16311,Chet Padilla,M,18/10/1985,34,115039,87966,27073,Solutions Architect.Senior.,Service Delivery Americas Web
21168,Blanche Villanueva,F,27/12/1988,31,117116,77977,39139,Customer Incident Manager II..,AmaTec - Incident Mgmt
11649,Maritza Blevins,F,5/1/87,33,115776,63032,52744,Business Systems Analyst.Senior II Lead.,Enterprise Applications
18246,Eduardo Brewer,M,1/7/87,33,117214,42907,74307,Software Development Engineer in Test.Senior II.,LUNA/OPEN Engineering
5699,Jim Rich,M,18/09/1977,42,117630,60220,57410,Manager..HR Operations,International - HR Operations
18754,Xavier Bates,M,13/08/1982,37,117194,66879,50315,Business Systems Analyst.Senior II.,Corporate Systems
5734,Jose Santiago,M,27/05/1984,36,114583,85512,29071,User Interface Engineer.Senior.,GSS EPIC Engineering (HC COGS)
8140,Dianne Olson,F,23/02/1991,29,114693,66322,48371,Software Engineer.Senior II.,Enterprise Applications
14354,Agustin Proctor,M,6/12/80,39,114830,93222,21608,Manager..Collections,Finance - Customer Revenue Operations G&A
12254,Angelo Lynch,M,2/5/84,36,114308,70517,43791,Software Development Engineer in Test.Senior II Lead.,Media Portal
18800,Paulette Irwin,F,23/06/1991,29,116985,95834,21151,Software Development Engineer in Test.Senior II.,Media Experience SQA
17412,Willie Bell,M,23/07/1989,30,114713,70029,44684,Software Development Engineer in Test.Senior II.,Media Experience SQA
16292,Jere Roy,M,13/10/1988,31,115439,65691,49748,Software Development Engineer in Test.Senior II.,Media Experience SQA
11997,Ellsworth Barajas,M,1/9/90,29,116667,55037,61630,Network Engineer.Senior.,Networks - Technology
17769,Phoebe Vang,F,18/08/1978,41,115827,86655,29172,Manager..Training,Engineering Learning
8806,Jewell Lynch,M,9/2/91,29,116600,67220,49380,Solutions Architect.Senior Lead.,GSS EPIC Product Evaluation
4202,Hipolito Tyler,M,8/6/80,40,117563,62372,55191,Network Engineer.Senior Lead.,Networks - Technology
22219,Jessie Chambers,M,5/6/80,40,116288,59108,57180,Network Account Manager..,Networks - APJ Infrastructure
16476,Kip Christian,M,16/01/1986,34,116609,72264,44345,Solutions Architect.Senior.,Service Delivery Americas Web
15298,Valentine Kramer,M,25/08/1985,34,115887,86364,29523,Systems Support Engineer.Senior II.,IT DevOps
21936,Ira Lester,M,23/07/1987,32,116293,69881,46412,Software Engineer.Senior Lead.,Enterprise Applications
15516,Leandro Herman,M,20/12/1987,32,118266,87248,31018,Systems Engineer.Principal.,Developer Productivity
5737,Man Mullen,M,12/12/85,34,117278,69400,47878,Technical Project Manager.Senior.,Core West - PS
18243,Jarred Mata,M,3/11/83,36,116082,63566,52516,Support Delivery Manager II..,AmaTec - SDM
14169,Erma Cervantes,F,20/09/1982,37,117878,70284,47594,Q/A Engineer.Senior II.,IT DevOps
4693,Gerald Carrillo,M,2/3/82,38,119622,90609,29013,Manager..Account Management,Americas- AMG
12277,Jude Jones,M,19/03/1985,35,116755,66526,50229,Capacity Planning Manager..,Networks - Planning
16923,Dana Ferrell,F,1/4/88,32,119858,86883,32975,Software Engineer.Senior II.,Web Performance Engineering
7083,Andreas Padilla,M,6/10/84,35,117035,88278,28757,Program Manager.Senior.Technical,GSS Service Delivery Mgmt
16239,Nelson Townsend,M,12/2/89,31,117219,55403,61816,Software Engineer.Senior II.,Media Analytics
16432,Keith Deleon,M,22/08/1989,30,120037,44195,75842,Software Engineer.Senior II.,Media Analytics
22428,Roman Gonzales,M,10/1/88,32,119936,80131,39805,Business Systems Analyst.Senior II Lead.,Corporate Systems
11672,Raul Roberson,M,1/1/83,37,117829,82034,35795,Software Development Engineer in Test.Senior II Lead.,Media Experience SQA
11740,Brenton Frank,M,18/08/1987,32,117193,91576,25617,Software Engineer.Senior II.,Corporate Systems
4028,Dewayne Copeland,M,23/04/1983,37,118655,87252,31403,Incident Manager..,Platform Operations
15791,Fredric Mcneil,M,8/3/88,32,118194,61509,56685,Solutions Architect.Senior.,APJ Security Services
4900,Billy Jefferson,M,19/11/1982,37,119605,68947,50658,Customer Incident Manager II..,AmaTec - Incident Mgmt
20087,Arline Bryan,F,16/08/1989,30,118866,90870,27996,Software Development Engineer in Test.Senior II Lead.,Dynamic Media SQA
17301,Gordon Zamora,M,19/04/1987,33,118697,72940,45757,Program Manager.Senior.Technical,GSS EPIC Engineering (HC COGS)
12275,Roman Drake,M,11/5/89,31,119422,68206,51216,Applications Developer.Senior Lead.,Marketing - Website Management
11836,Odell Blackburn,M,9/11/87,32,118205,67241,50964,Software Engineer.Senior II.,Media Services Engineering
6919,Merle Nolan,M,10/8/87,32,117304,85255,32049,Solutions Architect.Senior.,Service Delivery APJ
4941,Maurice Bradley,M,24/09/1982,37,117729,78390,39339,Manager.Senior.Financial Operations,Finance - Customer Revenue Operations G&A
4203,Stephen Espinoza,M,1/10/80,39,119479,70050,49429,Manager..Engineering,Corporate Systems
20761,Bruce Ruiz,M,13/04/1986,34,119732,70269,49463,Web Developer.Senior.,Marketing - Website Management
19673,Abdul Watkins,M,19/08/1972,47,120300,116781,3519,Manager..Account Management,Americas- AMG
17264,Mckinley Sullivan,M,3/9/86,33,121165,81155,40010,Software Development Engineer in Test.Senior II.,Media Experience SQA
18708,Jorge Odom,M,5/9/91,28,119847,68955,50892,Security Operations Center Specialist.Senior.,APJ Security Services - SOCC
5349,Dorian Villegas,M,30/03/1980,40,120381,88361,32020,Manager..Account Management,Americas- AMG
8633,Gilberto Chaney,M,6/12/87,32,119109,70211,48898,Manager..Q/A Engineering,IT DevOps
6597,Leroy Cook,M,6/12/84,35,118521,84695,33826,Software Engineer.Senior.,Networks - Productivity - Systems
19645,Delmer Gillespie,M,3/7/85,35,120490,67836,52654,System Operations Engineer.Senior II.,Enterprise Access Engineering
8654,Jonathon Moreno,M,20/05/1985,35,118739,75070,43669,Software Engineer.Senior II Lead.,Enterprise Applications
14862,Leigh Waller,F,29/09/1990,29,118548,84887,33661,Software Engineer.Senior II.,Enterprise Applications
15977,Carmine Evans,M,1/1/88,32,118785,88391,30394,Technical Project Manager.Senior.,Mobile Product
19939,Elden Lee,M,15/07/1985,35,120756,64722,56034,System Operations Engineer.Senior II Lead.,Media Experience SQA
6558,Edmundo Vega,M,11/6/86,34,120224,74667,45557,Manager..Systems Engineering,GSS EPIC Engineering (HC COGS)
22013,Efrain Terrell,M,16/07/1987,32,120043,70411,49632,Program Manager II..Technical,Media Engineering Program Management
21934,Barney Hopkins,M,21/03/1986,34,119851,78539,41312,Software Development Engineer in Test.Senior II Lead.,Media Portal
19704,Zack Brewer,M,13/05/1987,33,120245,71016,49229,Software Engineer.Senior II.,Corporate Systems
18589,Francisco Raymond,M,1/4/84,36,121566,92520,29046,Systems Engineer.Senior.,Developer Productivity
14687,Emmanuel Morgan,M,3/9/91,28,119814,75262,44552,Security Operations Center Specialist.Senior.,APJ Security Services - SOCC
15570,Joseph Sharp,M,21/07/1988,31,122472,97929,24543,Data Scientist.Senior.,Marketing Data Analytics
5459,Toby Newman,M,24/03/1980,40,122046,69400,52646,Reliability Engineer.Senior.,Technology
11948,Clifford Villegas,M,15/08/1982,37,120067,58217,61850,Software Engineer.Senior II Lead.,Corporate Systems
10534,Norberto Berg,M,8/1/86,34,123676,89776,33900,Software Engineer.Senior II.,Platform Mapping Engineering
14252,Markus Powell,M,17/05/1984,36,123298,82294,41004,Relationship Manager.Senior.,Web Americas Inside Sales East
11122,Sanford Gaines,M,24/02/1986,34,124155,72611,51544,Solutions Architect.Senior.,Service Delivery Americas Web
18863,Gavin Andrade,M,1/6/90,30,124221,71923,52298,Systems Engineer.Senior.,Developer Productivity
23023,Anderson Larson,M,12/2/88,32,123388,116652,6736,Solutions Architect.Senior.,APJ Security Services
3942,Phil Keith,M,1/8/84,35,123151,70620,52531,Compensation and Benefits Specialist.Senior.,International - Comp & Ben
10802,Weldon Hurley,M,9/4/84,36,124072,80372,43700,Software Engineer.Senior II.,Corporate Systems
7268,Sidney Mcclure,M,27/08/1987,32,122547,70383,52164,Systems Support Engineer.Senior II Lead.,IT DevOps
15303,Hilario Sharp,M,6/8/84,35,122951,77581,45370,Technical Project Manager.Senior.,Core East - PS
11329,Alden Tucker,M,30/01/1987,33,123457,91326,32131,Systems Support Engineer.Senior II.,IT DevOps
11225,Royce Strickland,M,1/6/88,32,123503,75641,47862,Systems Support Engineer.Senior II.,LUNA/OPEN Engineering
17380,Von Ritter,M,13/04/1985,35,123355,69862,53493,Software Engineer.Senior.,Web Performance Engineering
17000,Jeromy Dean,M,8/4/85,35,124181,92138,32043,Systems Administrator.Senior.UNIX,Enterprise Infrastructure Services
20629,Brandon Pearson,M,1/10/82,37,124435,78827,45608,Business Systems Analyst.Senior II.,IT Product Management & Ops
19177,Marlon Orozco,M,30/03/1980,40,124294,91701,32593,Security Operations Center Specialist.Senior.,APJ Security Services - SOCC
16344,Omer Coleman,M,1/5/88,32,125059,65558,59501,Software Engineer.Senior II.,Media Analytics
8612,Garry Rosales,M,1/8/85,34,121683,74710,46973,Shift Manager..Platform Operations,Platform Operations
15743,Chuck Kaufman,M,17/08/1989,30,125223,81959,43264,System Operations Engineer.Senior II Lead.,Security Engineering
20332,Leif Mack,M,1/5/91,29,122227,71934,50293,Software Engineer.Senior.,Enterprise Access Engineering
18479,Emile Palmer,M,29/11/1988,31,124565,90811,33754,Security Operations Center Network Engineer..,APJ Security Services - SOCC
4512,Wilber Travis,M,7/2/85,35,125632,81075,44557,Network Engineer.Senior Lead.,Networks - Technology
2924,Quinn Marquez,M,27/11/1978,41,124649,51266,73383,Manager..Payroll,Finance - Accounting
12123,Tanisha Flowers,F,22/03/1991,29,123230,72191,51039,Software Engineer.Senior II.,Media Services Engineering
10505,Marshall Odonnell,M,5/3/84,36,122815,72438,50377,Software Development Engineer in Test.Senior II.,Media Services Engineering
6334,Tristan Davila,M,10/5/82,38,125217,81681,43536,Manager..Product Operations,IT Product Management & Ops
8033,Felecia Manning,F,1/1/84,36,123302,81149,42153,Manager..Business Operations,Marketing - Operations
7446,Malik Drake,M,8/3/84,36,124132,73457,50675,Manager..Finance,Financial Planning and Analysis
9869,Nathaniel Bush,M,25/11/1988,31,125449,90472,34977,Solutions Architect.Senior.,Service Delivery APJ
18265,Frankie Stafford,M,20/09/1987,32,123948,90819,33129,Manager..Technical Support,AmaTec - Mgmt
19192,Mary Bartlett,M,15/04/1984,36,126211,86693,39518,Systems Administrator.Senior Lead.UNIX,Enterprise Infrastructure Services
19455,Del Parks,M,30/06/1989,31,125251,74416,50835,Security Operations Center Specialist.Senior.,APJ Security Services - SOCC
8635,Damian Bolton,M,19/02/1986,34,122857,70759,52098,Software Engineer.Senior II Lead.,Enterprise Applications
12371,Hayden Ballard,M,28/03/1986,34,124612,70328,54284,Software Engineer.Senior II Lead.,Corporate Systems
16441,Alfonzo Kennedy,M,13/06/1987,33,125450,70980,54470,Enterprise Security Architect.Senior.,APJ Security Sales
14829,Lon Peters,M,19/04/1979,41,126312,79658,46654,Supervisor..Help Desk,Enterprise Infrastructure Services
14895,Aurelio Gregory,M,20/06/1987,33,126836,75266,51570,Software Development Engineer in Test.Senior II.,Storage Engineering
8452,Sammie Lang,M,2/10/88,31,123221,60964,62257,Architect..,App Architecture & Integration Services
10521,Geraldo Proctor,M,30/03/1984,36,126183,75095,51088,Software Development Engineer in Test.Senior II Lead.,Storage Engineering
14688,Tomas Griffith,M,12/11/85,34,123505,77338,46167,Security Operations Center Network Engineer..,APJ Security Services - SOCC
6215,Harriet Vargas,F,11/1/82,38,124859,74302,50557,Technical Solutions Engineer.Senior.,AmaTec - Americas TSE
7315,Leonard Burch,M,20/11/1990,29,124104,70632,53472,Software Engineer.Senior II.,Media Ghost
16523,Eliseo Santana,M,7/6/87,33,127064,71339,55725,Software Engineer.Senior II.,Corporate Systems
14328,Billy Galloway,M,21/02/1987,33,126789,71950,54839,Software Engineer.Senior II.,Media Delivery Product Engineering
8384,Mohammed Hubbard,M,29/04/1985,35,127664,74560,53104,Software Engineer.Senior II.,Media Services Engineering
21116,Clair Reeves,M,2/3/88,32,125790,98147,27643,Technical Project Manager II..,Web Americas - ECG
7668,Hosea Acosta,M,23/08/1983,36,126487,75859,50628,Systems Support Engineer.Senior II Lead.,IT DevOps
8715,Neva Pace,F,25/02/1970,50,124850,70271,54579,Human Resources Business Partner II..,International - Business Partners
17486,Isreal Barton,M,6/8/87,32,125887,73924,51963,Software Engineer.Senior II.,Corporate Systems
20529,Margarito Barajas,M,15/04/1985,35,126160,80819,45341,Software Development Engineer in Test.Senior II.,Media Experience SQA
6563,Darren Randolph,M,1/8/86,33,124999,97268,27731,Practice Manager..,GSS Service Delivery Mgmt
11169,Arnoldo Lawrence,M,20/01/1986,34,126655,95174,31481,Technical Project Manager.Senior.,Core West - PS
16223,Shawn Watts,M,20/05/1986,34,125613,92408,33205,Solutions Architect.Senior.,APJ Security Services
20192,Rudolph Daniel,M,15/07/1988,32,124707,77920,46787,Software Engineer.Senior II.,Enterprise Access Engineering
19085,Darnell Johnston,M,15/03/1988,32,128753,84025,44728,Software Development Engineer in Test.Senior II.,DPM Engineering
7309,Dario Lang,M,22/12/1990,29,126793,75394,51399,Product Support Engineer.Senior.,Media Reliability Engineering
14058,Chong Shelton,M,20/04/1989,31,128763,75161,53602,Data Engineer.Senior II Lead.,Data Engineering Analytics & Intelligence
5801,Frances Oneal,M,12/3/87,33,127819,78959,48860,Software Development Engineer in Test.Senior II Lead.,Dynamic Media SQA
11247,Wanda Hernandez,F,31/10/1985,34,128076,71617,56459,Software Engineer.Senior II.,Media Analytics
8807,Sanford Huang,M,17/03/1991,29,128470,75814,52656,Solutions Architect.Senior.,Service Delivery EMEA
7101,Marquita Becker,F,1/4/86,34,127404,78380,49024,Software Development Engineer in Test.Senior II.,Media Analytics
22956,Darrin Guzman,M,16/09/1991,28,128350,124666,3684,Network Administrator..,Enterprise Infrastructure Services
8432,Luis Mccarty,M,5/3/80,40,128753,79615,49138,Manager.Senior.Account Management,Americas- AMG
9417,Taylor Buckley,M,28/05/1989,31,127304,73583,53721,Software Engineer.Senior II.,Enterprise Applications
15329,Mose Estes,M,20/10/1983,36,128591,91612,36979,Relationship Manager.Senior.,Media AMER Sales ECG
6276,Trinidad Stanley,M,22/04/1990,30,129332,75661,53671,Performance Engineer.Senior II.,Product - Custom
18584,Malcolm Petty,M,23/02/1984,36,129690,74402,55288,Relationship Manager II..,Web Americas Field East
9092,Daren Garrison,M,15/09/1981,38,126651,85863,40788,Partner Enablement Manager.Senior.,APJ Channel Pre-Sales
17479,Cecil Alexander,M,28/10/1985,34,127375,93957,33418,Software Engineer.Senior II.,Corporate Systems
18662,Brock Dorsey,M,30/11/1981,38,127231,55975,71256,Software Development Engineer in Test.Senior II.,Media Portal
20525,Benito Mckinney,M,8/9/89,30,128948,74492,54456,Software Engineer.Senior.,Enterprise Access Engineering
15125,Columbus Irwin,M,18/09/1990,29,130872,86457,44415,Product Support Engineer..,AmaTec - PSG
8237,Jordon Porter,M,9/1/78,42,130158,78815,51343,Systems Administrator.Senior Lead.UNIX,Enterprise Infrastructure Services
9846,Patrica Walton,F,22/09/1984,35,130116,87330,42786,Manager..Engineering,Enterprise Applications
6677,Christopher Adams,M,26/07/1990,29,128573,77767,50806,Software Engineer.Senior II Lead.,Enterprise Applications
5976,Royal Shah,M,31/12/1983,36,130976,45634,85342,Manager..Q/A Engineering,IT DevOps
22910,Regina Holloway,F,9/10/91,28,128854,125994,2860,Release Engineer II..,Enterprise Access Engineering
22984,Vonda Wood,F,16/02/1982,38,129365,121934,7431,Software Engineer.Senior.,Corporate Systems
10522,Freddie Nielsen,M,17/05/1988,32,131163,81363,49800,Product Support Engineer..,AmaTec - PSG
9100,Clarence Caldwell,M,3/9/77,42,130683,95017,35666,Systems Engineer.Senior.,Enterprise Infrastructure Services
15975,Harvey Daugherty,M,14/09/1985,34,131590,95787,35803,Solutions Architect.Senior.,APJ Security Services
22354,Kelvin Gamble,M,25/10/1988,31,129330,60613,68717,Systems Engineer.Senior.,Developer Productivity
22770,Chadwick Mcclure,M,9/4/86,34,130787,42104,88683,Software Engineer.Senior II.,GSS EPIC Engineering (HC COGS)
18634,Damon Marsh,M,11/7/90,30,129536,76504,53032,Relationship Manager..,Web Americas Inside Sales East
15457,Zackary Matthews,M,8/3/85,35,132722,80700,52022,Q/A Engineer.Senior II.,Enterprise Access Engineering
21788,Seymour Hull,M,29/08/1990,29,130802,95221,35581,Software Engineer.Senior.,Enterprise Networks
18102,Bart Huerta,M,6/5/87,33,133177,73884,59293,Software Engineer.Senior II.,LUNA/OPEN Engineering
17836,Kendrick Fuller,M,10/6/83,37,131734,78773,52961,Software Development Engineer in Test.Senior II Lead.,Media Services Engineering
17402,Zachariah Blanchard,M,28/01/1988,32,130091,94344,35747,Security Operations Center Specialist.Senior.,APJ Security Services - SOCC
6860,Myron Hammond,M,18/12/1988,31,130378,72929,57449,Product Support Engineer..,AmaTec - PSG
16544,Odis Lee,M,15/04/1986,34,130671,90044,40627,Technical Project Manager.Senior Lead.,APJ Security Services
20614,Mose Duran,M,15/11/1987,32,130671,94774,35897,Relationship Manager II..,Web Americas Inside Sales East
18626,Cesar Nixon,M,29/01/1984,36,130585,83680,46905,Software Engineer.Senior II Lead.,Media Portal
22785,Raphael Oconnor,M,8/12/80,39,132123,110014,22109,Manager.Senior.Financial Operations,Finance - Customer Revenue Operations G&A
6701,Warren Huang,M,5/8/86,33,130488,74300,56188,Software Development Engineer in Test.Principal Lead.,Media Analytics
14722,Elmer Foster,M,25/01/1985,35,133143,98382,34761,Solutions Architect.Senior Lead.,Service Delivery APJ
21839,Burton Glover,M,8/2/87,33,132500,73836,58664,System Operations Engineer.Senior II.,Enterprise Access Engineering
4074,Demarcus Carney,M,16/12/1981,38,133380,86112,47268,Finance Systems Analyst.Senior Lead.,Financial Planning and Analysis
8091,Abel Moreno,M,10/2/89,31,131944,74559,57385,Security Operations Center Specialist.Senior.,APJ Security Services - SOCC
10008,Roberta Lowery,F,27/03/1985,35,132847,93764,39083,Software Development Engineer in Test.Senior II Lead.,Enterprise Networks
2944,Willard Durham,M,11/3/78,42,134140,67185,66955,Manager..Platform Operations,Platform Operations
4158,Thelma Underwood,F,19/11/1978,41,133119,101880,31239,Manager..Technical Support,AmaTec - Mgmt
8816,Damien Roberts,M,4/11/91,28,132547,77852,54695,Product Support Engineer.Senior.,AmaTec - PSG
19018,Milan Wilson,M,30/03/1985,35,134052,75815,58237,Software Development Engineer in Test.Senior II Lead.,DPM Engineering
10919,Dexter Vaughan,M,20/03/1978,42,133450,96290,37160,Software Development Engineer in Test.Principal.,Dynamic Media SQA
17130,Wes David,M,14/07/1977,43,135982,90707,45275,Practice Manager..,GSS Service Delivery Mgmt
21379,Hung Crosby,M,25/04/1983,37,133478,100180,33298,Manager..Technical Support,AmaTec - Mgmt
17941,Kermit Richard,M,15/07/1988,32,135519,86121,49398,Software Engineer.Senior II.,Developer Productivity
6987,Josiah Guerra,M,15/12/1985,34,134459,96125,38334,Practice Manager.Senior.,GSS EPIC Product Evaluation
22901,Francisco Leon,M,17/01/1989,31,135172,113152,22020,Site Reliability Engineer.Senior.,Security Engineering
3960,Jerold Mcmahon,M,23/06/1982,38,135606,91126,44480,Program Manager.Senior Lead.,Customer Experience
6288,Paris Pollard,M,5/12/89,30,136913,97052,39861,Software Engineer.Senior II Lead.,Media Services Engineering
10460,Sal Briggs,M,15/07/1978,42,134322,73017,61305,Program Manager.Senior.Technical,LUNA Program Management
21849,Martin White,M,20/02/1991,29,137767,86870,50897,Support Delivery Manager..,AmaTec - SDM
11668,Myra Hill,F,15/07/1983,37,136060,95912,40148,Engagement Manager.Senior.,APJ EM - SA/IN
4086,Erich Anthony,M,14/11/1983,36,135994,78346,57648,Manager..Software Development Engineer in Test,Media Experience SQA
8741,Ollie Mccall,M,30/03/1987,33,138686,76723,61963,Architect..,AmaTec - APS
8997,Doyle Lewis,M,7/9/86,33,136930,71768,65162,Relationship Manager II..,Media AMER Sales ECG
4991,Leann Bartlett,F,7/3/81,39,138527,87525,51002,Manager.Senior.Sales Operations,Web Division Sales Ops
18222,Cameron Brennan,M,9/8/85,34,138230,120780,17450,Program Manager II..Technical,PlatEng Management
17716,Al Hawkins,M,5/4/73,47,137820,83855,53965,Manager..System Operations,Media Reliability Engineering
7379,Jerrold Kennedy,M,3/9/84,35,135475,91422,44053,Software Engineer.Senior II Lead.,Corporate Systems
21686,Ivory Price,M,5/9/83,36,135301,86970,48331,Q/A Engineer.Senior II Lead.,IT DevOps
5630,Shelby Wu,M,25/05/1984,36,137655,76494,61161,Software Development Engineer in Test.Senior II.,Syscomm
5048,Daren Copeland,M,22/08/1984,35,137390,97705,39685,Manager..Technical Support,AmaTec - Mgmt
16712,Drew Cooley,M,7/2/90,30,135813,104063,31750,Software Engineer.Senior II.,Enterprise Access Engineering
4160,Carlene Osborne,F,9/8/84,35,136629,80565,56064,Systems Support Engineer.Senior II Lead.,LUNA/OPEN Engineering
17429,Louisa Mosley,F,6/7/84,36,136717,97010,39707,Solutions Architect.Senior Lead.,Service Delivery EMEA
5137,Allison Houston,F,24/02/1985,35,139175,91899,47276,Support Delivery Manager.Senior.,AmaTec - SDM
14290,Sherwood Preston,M,20/06/1985,35,136121,70410,65711,Software Engineer.Senior II.,Media Services Engineering
22957,Ruben Ayers,M,28/01/1985,35,136534,106335,30199,Program Manager.Senior.Technical,Networks - Planning
8814,Blake Hall,M,8/5/91,29,139446,77424,62022,Software Engineer.Senior II.,LUNA/OPEN Engineering
22783,Brent Cannon,M,13/07/1982,38,138705,89443,49262,Support Delivery Manager..,AmaTec - SDM
18808,Jeffrey Dickerson,M,28/05/1987,33,138710,100994,37716,Product Architect..,LUNA/OPEN Engineering
17873,Deshawn Donaldson,M,26/02/1984,36,139693,78873,60820,Software Engineer.Senior II Lead.,Media Portal
20427,Solomon Glass,M,10/5/88,32,137785,103342,34443,Site Reliability Engineer.Senior II.,Security Engineering
19117,Felipe Novak,M,14/01/1981,39,137311,85745,51566,Practice Manager..,GSS Service Delivery Mgmt
6595,Lou Escobar,M,15/07/1985,35,139947,79837,60110,Solutions Architect.Senior II.,Service Delivery Americas Web
20507,Mauro Mcgee,M,30/11/1984,35,140160,81292,58868,Software Engineer.Senior II.,Media Ghost
5179,Merle Fritz,M,11/10/86,33,137617,76834,60783,Software Engineer.Senior II Lead.,Media Analytics
6003,Ferdinand Hernandez,M,26/11/1989,30,138935,48999,89936,Software Engineer.Senior II.,Media Portal
15340,Jamie Good,M,19/01/1987,33,140389,81384,59005,Software Engineer.Senior II.,Media Reliability Engineering
10538,Tonia Harrison,F,5/7/88,32,137107,87123,49984,Manager..Technical Support,AmaTec - Mgmt
10872,Arnoldo Mack,M,14/07/1985,35,138770,97992,40778,Software Engineer.Senior II Lead.,Media Analytics
6965,Rex Humphrey,M,22/06/1986,34,137296,90146,47150,Product Marketing Manager..,Media Global Industry Marketing
10881,Monroe Washington,M,15/05/1990,30,139501,76762,62739,Software Engineer.Senior II.,Enterprise Access Engineering
15479,Herbert Randall,M,5/5/85,35,139471,101004,38467,Business Systems Analyst.Senior II Lead.,Enterprise Applications
16208,Sean Moody,M,17/07/1987,32,137692,74329,63363,Software Engineer.Senior II Lead.,Media Portal
6285,Wendell Forbes,M,30/12/1987,32,141112,72059,69053,Software Engineer.Senior II Lead.,Enterprise Applications
17453,Javier Cordova,M,30/05/1986,34,139697,139587,110,Software Development Engineer in Test.Senior.,Storage Engineering
5942,Theodore Donovan,M,13/03/1982,38,139826,75476,64350,Services Analyst.Principal.,Service Delivery Excellence
9904,Van Cabrera,M,15/07/1980,40,139516,87491,52025,Manager..Q/A Engineering,IT DevOps
20543,Ed Whitaker,M,29/09/1981,38,139143,102922,36221,Manager..Technical Support,AmaTec - Mgmt
17751,Teri Eaton,F,25/06/1988,32,142269,78953,63316,Software Engineer.Senior II Lead.,Enterprise Applications
5132,Cristopher Morrison,M,27/02/1981,39,138901,77107,61794,Software Engineer.Senior II Lead.,Media Analytics
4032,Douglas Yu,M,20/08/1981,38,139989,99347,40642,Manager.Senior.Financial Operations,Finance - Customer Revenue Operations G&A
4886,Cyrus Collier,M,29/12/1982,37,140719,101910,38809,Manager..Engineering,Networks - Productivity - Systems
4607,Shaun Watkins,M,16/10/1987,32,139363,79676,59687,Manager..Technical Support,AmaTec - Mgmt
17637,Rogelio Wheeler,M,10/12/87,32,142525,79570,62955,Software Engineer.Senior II.,Platform Mapping Engineering
15572,Kenton Freeman,M,3/10/80,39,140654,89846,50808,Software Development Engineer in Test.Senior II.,Dynamic Media SQA
17184,Alan Clark,M,6/1/82,38,141643,101628,40015,Manager..Software Development Engineer in Test,Web Performance Engineering
10870,Shon Clay,M,11/6/84,36,143711,83993,59718,Manager..Engineering,Corporate Systems
8693,Lesley Carroll,M,1/4/79,41,143231,79094,64137,Manager..Software Development Engineer in Test,Dynamic Media SQA
5444,Nelson Roy,M,20/08/1979,40,143445,105301,38144,User Interface Engineer.Senior II.,GSS EPIC Engineering (HC COGS)
12217,Bob Duran,M,5/10/84,35,143489,72155,71334,Practice Manager..,GSS Service Delivery Mgmt
21720,Pedro Bryant,M,13/02/1977,43,142965,101102,41863,Manager..Network Administration,Enterprise Infrastructure Services
12278,Zackary Copeland,M,7/2/83,37,144554,93997,50557,Technical Project Manager.Senior Lead.,APJ Security Services
22300,Brittney Mann,F,9/9/88,31,144820,116582,28238,Support Delivery Manager..,AmaTec - SDM
3034,Edison Page,M,29/05/1970,50,145029,102955,42074,Product Support Engineer.Senior.,AmaTec - PSG
4231,Joe Moses,M,2/5/86,34,143214,95297,47917,Client Service Manager.Senior II.,Americas- AMG
4585,Darrel Montes,M,13/03/1980,40,144509,68493,76016,Manager..Sales Operations,Global Sales Ops
15300,Denise Hoover,F,13/07/1982,38,144568,78183,66385,Software Engineer.Senior II.,Security Engineering
11674,Trevor Munoz,M,8/4/88,32,144264,82306,61958,Security Operations Center Specialist.Senior II.,APJ Security Services - SOCC
10899,Major Mason,M,14/02/1987,33,143211,76360,66851,Architect.Senior.,Media Experience Product Architecture
10411,Jackie Castaneda,M,13/01/1985,35,146118,87052,59066,Software Development Engineer in Test.Senior II Lead.,LUNA/OPEN Engineering
4608,Delmar Meyers,M,15/03/1978,42,144898,82407,62491,Escalation Manager..,APJ Security Services - SOCC
17164,Lesley Ellison,M,27/04/1986,34,147429,103896,43533,Software Engineer.Senior II.,Media Portal
22010,Quintin Malone,M,6/5/79,41,146497,93830,52667,Manager.Senior.IT Help Desk Services,Enterprise Infrastructure Services
22220,Jeannine Bowers,F,1/2/83,37,146683,72012,74671,Program Manager.Senior.Technical,Media Engineering Program Management
8025,Russel Boyd,M,5/8/85,34,146814,81575,65239,Manager..Engineering,Corporate Systems
3976,Celeste Moran,F,17/05/1983,37,147484,81825,65659,Manager.Senior.Account Management,Americas- AMG
6216,Laura Singleton,F,9/10/84,35,144346,101638,42708,Technical Enablement Strategist.Senior.,GSS Technical Enablement
3727,Lester Patton,M,24/12/1982,37,144979,68596,76383,Relationship Manager.Senior Lead.,Web Americas Inside Sales East
3357,Christopher Mccullough,M,24/06/1982,38,147866,29571,118295,Manager..Platform Operations,Platform Operations
17059,Roosevelt Noble,M,13/07/1988,32,146055,65478,80577,Software Engineer.Senior II.,Web Performance Engineering
14019,Otis Lawrence,M,23/12/1985,34,147469,81991,65478,Software Engineer.Senior II Lead.,Media Portal
8090,Burt Vincent,M,3/1/80,40,147355,105114,42241,Manager..Service Line,APJ Security Management
7320,Phyllis Haas,F,5/3/91,29,146638,78670,67968,Manager..Platform Operations,Platform Operations
14235,Jerome Whitney,M,8/8/84,35,146633,100166,46467,Database Administrator.Senior Lead.,Enterprise Infrastructure Services
21493,Sergio Wilcox,M,25/06/1986,34,149196,87715,61481,Software Engineer.Senior II.,Enterprise Networks
17178,Leslie Pineda,M,20/05/1987,33,149874,75512,74362,Software Engineer.Senior II.,Web Performance Engineering
5545,Adrienne Vasquez,F,31/05/1981,39,147404,75560,71844,Manager..Software Development Engineer in Test,Media Analytics
7685,Elisabeth Leon,F,18/12/1986,33,148341,104483,43858,Manager..ECG,Web Americas Inside Sales East
4212,Rey Rollins,M,22/08/1982,37,147461,95091,52370,Manager.Senior.Account Management,APJ - AMG
11626,Malcolm Hickman,M,6/12/86,33,149308,79699,69609,Software Engineer.Senior II Lead.,Enterprise Networks
6400,Antoine Cordova,M,21/06/1985,35,149843,59556,90287,Manager..Engineering,Corporate Systems
11934,Nathaniel Ellis,M,24/04/1987,33,150907,84711,66196,Software Engineer.Senior II Lead.,Media Portal
11893,Blair Bernard,M,16/08/1988,31,148046,91417,56629,Relationship Manager.Senior.,Web Americas Inside Sales East
6471,Joseph Mckenzie,M,17/05/1985,35,147408,79385,68023,Practice Manager..,GSS Service Delivery Mgmt
19062,Evan Chen,M,14/09/1986,33,147664,87440,60224,Manager..Engineering,App Architecture & Integration Services
22902,Javier Lowery,M,30/06/1985,35,150188,132497,17691,Infrastructure Delivery Manager..,Networks - APJ Infrastructure
4979,Charley Simmons,M,30/04/1974,46,148408,71149,77259,Program Manager.Senior.Technical,CIO Management
16587,Joseph Brooks,M,10/5/88,32,151167,72736,78431,Performance Engineer.Senior II.,Product - Custom
15094,Virgilio Wu,M,29/05/1987,33,150137,95076,55061,Product Architect..,GSS EPIC Engineering (HC COGS)
10839,Dionne Griffith,F,21/12/1980,39,151340,111560,39780,Relationship Manager II..,Media AMER Sales ECG
15056,Milan Barnett,M,23/09/1986,33,148430,81276,67154,Software Engineer.Senior II Lead.,Media Analytics
20666,Mario Wood,M,30/09/1977,42,151458,59547,91911,Manager..Engineering,Media Portal
19791,Jordan Hopkins,M,15/05/1979,41,151312,109094,42218,Software Engineer.Senior II.,Developer Productivity
2830,Micheal Wall,M,21/10/1975,44,149126,66286,82840,Performance Engineer.Senior II.,Technology
16500,Scottie Calhoun,M,15/05/1983,37,150558,64563,85995,Program Manager.Senior.Technical,Program Management
17438,Sid Thomas,M,19/07/1988,31,151723,100957,50766,Software Engineer.Senior II.,Developer Productivity
19948,Simon Griffith,M,25/06/1984,36,152256,91046,61210,Software Engineer.Senior II Lead.,Enterprise Applications
7944,Emery Kim,M,25/03/1987,33,152680,70425,82255,Software Engineer.Senior II Lead.,Media Ghost
17107,Merrill Simpson,M,13/10/1988,31,151415,85334,66081,Product Support Engineer.Senior Lead.,Media Reliability Engineering
14318,Eva Fletcher,F,14/07/1985,35,153394,92945,60449,Software Engineer.Senior II Lead.,Enterprise Applications
14928,Rae Glenn,F,15/07/1981,39,151988,98631,53357,Software Engineer.Senior II Lead.,LUNA/OPEN Engineering
4757,Dannie Montoya,M,5/8/83,36,154547,115457,39090,Manager..Network Design,Networks - Productivity
21381,Noe Le,M,17/05/1983,37,155580,113042,42538,Software Engineer.Senior II.,Enterprise Access Engineering
7195,Danny Cowan,M,30/04/1986,34,156134,85331,70803,Marketing Manager.Senior.,Media APJ Field Marketing
6841,Joyce Camacho,F,16/12/1979,40,155761,109559,46202,Practice Manager.Senior.,GSS Service Delivery Mgmt
20099,Ike Collins,M,30/12/1982,37,155509,86307,69202,Manager..Software Development Engineer in Test,LUNA/OPEN Engineering
22988,Hong Underwood,M,8/9/86,33,152917,144378,8539,Support Delivery Manager..,AmaTec - SDM
5521,Steven Velasquez,M,15/01/1979,41,156484,91189,65295,Manager..Online Properties,Marketing - Technical Marketing
6408,Lucien Khan,M,15/11/1985,34,154175,97671,56504,Solutions Engineer.Senior.,Media & Carrier Specialists
21565,Imelda Mathis,F,23/07/1973,46,155305,108471,46834,Manager.Senior.Learning Solutions,Learning & Development
8092,Susie Berger,F,23/12/1982,37,153722,152467,1255,Instructional Designer.Senior.,Learning & Development
9374,Shad Wells,M,1/10/85,34,156181,79870,76311,Manager..Engineering,LUNA/OPEN Engineering
21581,Milton Payne,M,11/10/86,33,156983,83931,73052,Support Delivery Manager..,AmaTec - SDM
22998,Scottie Avery,M,3/7/88,32,154414,146100,8314,Systems Engineer.Senior.,Enterprise Infrastructure Services
4782,Stacey Harrington,F,10/10/83,36,156612,109040,47572,Practice Manager.Senior.,GSS Service Delivery Mgmt
14835,Roberto Sparks,M,12/3/81,39,155686,80028,75658,Architect.Lead.,Media Portal
10167,Orlando Salas,M,19/12/1984,35,154850,83071,71779,Software Engineer.Senior II Lead.,Enterprise Networks
11742,Graig Church,M,8/1/88,32,158509,56473,102036,Manager..Service Line,Web Americas Services Management
22397,Nickolas Gardner,M,25/05/1982,38,155960,85178,70782,Manager..Software Development Engineer in Test,Media Services Engineering
20429,Ronnie Davis,M,17/03/1980,40,157730,106123,51607,Software Development Engineer in Test.Senior II Lead.,Dynamic Media SQA
9118,Edwardo Humphrey,M,1/6/82,38,159847,117522,42325,Software Development Engineer in Test.Principal Lead.,Storage Engineering
5759,Elijah Crosby,M,30/07/1988,31,158535,85583,72952,Manager..Reliability Engineering,Security Engineering
5794,Dustin Chen,M,11/6/81,39,160083,117935,42148,Shift Manager..Platform Operations,Platform Operations
7905,Marion Pratt,F,18/05/1987,33,160675,86558,74117,Manager..Engineering,IT DevOps
3892,Damian Brooks,M,12/4/82,38,162111,112624,49487,Software Development Engineer in Test.Principal Lead.,Media Ghost
6480,Forrest Francis,M,20/08/1981,38,159546,99872,59674,Manager..Engineering,Media Analytics
17863,Zackary Mora,M,1/2/86,34,161186,87005,74181,Software Development Engineer in Test.Principal.,Media Experience SQA
21156,Adalberto Zavala,M,9/11/87,32,162029,118235,43794,Product Support Engineer.Senior Lead.,Enterprise Networks
17108,Eugenio Acosta,M,6/6/79,41,162727,112282,50445,Systems Engineer.Principal.,Developer Productivity
14882,Peter Grimes,M,2/10/87,32,163628,101266,62362,Security Operations Center Specialist.Senior.,APJ Security Services - SOCC
9727,Hershel Simon,M,12/7/82,38,161755,107165,54590,Manager..Engineering,Developer Productivity
6238,Lori Pena,F,13/09/1984,35,164301,117871,46430,Manager.Senior.ECG,Web Americas Field West
8026,Kasey Hoffman,F,26/01/1985,35,162179,90026,72153,Program Manager.Senior.Technical,Global Channel - Enablement - SE
3272,Art Wells,M,25/12/1979,40,164283,90491,73792,Manager..System Operations,Enterprise Access Engineering
5728,Wes Copeland,M,22/12/1976,43,163883,116291,47592,Manager..Software Development Engineer in Test,Dynamic Media SQA
3796,Ricky Keith,M,20/01/1985,35,161557,90510,71047,Practice Manager..,GSS Service Delivery Mgmt
7416,Merle Peterson,F,1/3/81,39,163997,102963,61034,Manager.Senior.Business Applications,Enterprise Applications
10971,Lonnie Marsh,M,23/04/1982,38,165442,115001,50441,Site Reliability Engineer.Senior II.,LUNA/OPEN Engineering
19021,Pierre Andersen,M,1/8/74,45,165641,91332,74309,Manager..Q/A Engineering,Enterprise Access Engineering
10031,Cliff Friedman,M,20/04/1989,31,164486,92003,72483,Manager..Engineering,GSS EPIC Engineering (HC COGS)
7024,Truman Moore,M,18/02/1982,38,165567,111952,53615,Manager.Senior.Sales Operations,Media Division Sales Ops
9793,Kermit Mata,M,30/03/1982,38,165793,101674,64119,Manager..Engineering,GSS EPIC Engineering (HC COGS)
19563,Lee Pugh,F,2/3/77,43,167877,70772,97105,Human Resources Business Partner.Senior.,International - Business Partners
19091,Leon Weeks,M,31/12/1985,34,167368,85763,81605,Software Engineer.Senior II.,LUNA/OPEN Engineering
7529,Janine Mccarty,F,28/02/1979,41,165729,75845,89884,Manager.Senior.Product Operations,IT Product Management & Ops
18544,Buster Avila,M,26/05/1982,38,168484,90234,78250,Manager.Senior.Recruiting,Talent Acquisition
11143,Elmo Hutchinson,M,31/08/1985,34,169142,110651,58491,Practice Manager..,APJ Security Services - SOCC
9079,Leslie Santana,M,20/03/1979,41,168409,108284,60125,Manager..Engineering,Developer Productivity
21184,Amelia Duran,F,21/05/1983,37,170248,116903,53345,Counsel.Senior.,Legal
4403,Issac Bright,M,25/05/1982,38,172095,123709,48386,Manager.Senior.Network Delivery Architect,Networks - Planning
15306,Sammie Porter,M,15/05/1983,37,170952,91069,79883,Software Engineer.Principal Lead.,Media Analytics
8222,Royal Hahn,M,1/11/80,39,171223,68663,102560,Manager..Software Development Engineer in Test,Storage Engineering
5909,Phoebe Humphrey,F,5/8/82,37,174044,131235,42809,Manager..Software Development Engineer in Test,IT DevOps
2930,Nicky Pennington,M,22/05/1980,40,171672,119469,52203,Manager.Senior.Business Operations,Global Channel - Programs Support
11946,Alan Morris,M,31/08/1984,35,174458,117776,56682,Manager..Engineering,Media Portal
23037,Clement Ochoa,M,26/04/1984,36,173580,164157,9423,Product Manager.Senior.,Enterprise Product Management
18975,Coy Charles,M,8/4/76,44,172616,118292,54324,Manager.Senior.Facilities Operations,Global Real Estate and Workplace Productivity
16708,Mark Mckay,M,24/04/1983,37,174974,101744,73230,Software Engineer.Senior II Lead.,Enterprise Access Engineering
11835,Lester Becker,M,1/6/84,36,172044,102671,69373,Software Development Engineer in Test.Principal Lead.,Media Experience SQA
15859,Rick Morse,M,31/08/1984,35,174337,83596,90741,Performance Engineer.Senior II.,Technology
4165,Kurtis Faulkner,M,24/10/1979,40,173364,106791,66573,Manager..Engineering,Media Analytics
15790,Dane Ruiz,M,20/12/1977,42,174774,84914,89860,Manager..Engineering,Media Services Engineering
5322,Cleveland Brennan,M,10/10/85,34,172059,99869,72190,Manager..Technical Support,AmaTec - Mgmt
4646,Antone Santos,M,9/7/83,37,173603,92812,80791,Manager.Senior.Talent Sourcing and Research,Talent Acquisition
9200,Vincenzo Mejia,M,29/01/1980,40,176727,122321,54406,Practice Manager.Senior.,GSS Service Delivery Mgmt
5784,Carson Maddox,M,9/4/86,34,177549,70830,106719,Manager.Senior.Systems Support,IT DevOps
12372,Elise Golden,F,16/09/1981,38,175340,89816,85524,Product Manager.Senior.,IT Product Management & Ops
3434,Hans Brooks,M,9/10/82,37,176672,80501,96171,Manager.Senior.Technical Support,AmaTec - Mgmt
17902,Gordon Powers,M,27/07/1977,42,177363,95803,81560,Manager.Senior.Software Development Engineer in Test,Media Portal
17203,Jack Mcgee,M,15/07/1988,32,178557,95107,83450,Developer Evangelist..,Web Developer Relations
4680,Pat Munoz,M,18/09/1986,33,179851,123863,55988,Manager.Senior.Service Line,APJ Services Mgmt
18201,Tracey Stevenson,F,24/05/1988,32,180160,132269,47891,Relationship Manager.Senior.,Web Americas Inside Sales East
16709,Cyrus Figueroa,M,18/11/1982,37,179812,95031,84781,Q/A Engineer.Principal.,Enterprise Access Engineering
5194,Mckinley Lambert,M,5/12/86,33,180752,109360,71392,Manager..Solutions Engineering,Media APJ PreSales Mgmt
17935,Raymond Knight,M,7/8/84,35,179773,135633,44140,Support Delivery Manager II..,AmaTec - SDM
9293,Hubert Banks,M,7/8/80,39,180691,129226,51465,Manager.Senior.Digital Properties,Marketing - Website Management
15348,Jimmie Lozano,M,23/07/1989,30,180955,126927,54028,Practice Manager..,APJ Security Services - SOCC
7794,Casey Sherman,M,13/07/1987,33,180903,123440,57463,Manager.Senior.Marketing,Web APJ Field Marketing
16917,Mauro Whitney,M,20/12/1984,35,182187,116780,65407,Manager..Engineering,Web Performance Engineering
5057,Britt Stevenson,M,22/10/1987,32,182112,123319,58793,Software Engineer.Principal.,Corporate Systems
11442,Leslie Dominguez,M,3/12/81,38,181327,75314,106013,Manager..Engineering,Media Analytics
4995,Denis Griffin,M,1/1/83,37,184066,104019,80047,ECG Sales Manager..,Media AMER Sales ECG
20167,Sammie Sullivan,M,20/06/1984,36,181382,95024,86358,Manager..Engineering,LUNA/OPEN Engineering
15003,Letitia Dougherty,F,27/10/1983,36,181900,99986,81914,Manager.Senior.Product Operations,IT Product Management & Ops
4513,Rolando Luna,M,9/2/80,40,182013,125015,56998,Architect.Senior.,Enterprise Applications
7696,Thaddeus Walter,M,23/12/1983,36,182052,151178,30874,Manager.Senior.Q/A Engineering,IT DevOps
6576,Erik Buck,M,8/8/85,34,184975,107437,77538,Architect.Senior.,Corporate Systems
16710,Darwin Armstrong,M,28/06/1987,33,184875,93645,91230,Manager..Engineering,Enterprise Access Engineering
4773,Reed Oliver,M,7/6/79,41,186644,130534,56110,Manager.Senior.Q/A Engineering,IT DevOps
18915,Elinor Salazar,F,8/10/84,35,184839,125472,59367,Manager..Program Management Technical,PlatEng Management
3989,Tracy Curry,M,3/11/84,35,185268,70705,114563,Manager..Reliability Engineering,Technology
5571,Rico Sims,M,26/09/1980,39,186246,127135,59111,Manager.Senior.Engineering,Enterprise Applications
7220,Lucio Melendez,M,24/09/1980,39,186130,102762,83368,Manager.Senior.Solutions Engineering,Web APJ Presales Mgmt
14394,Frankie Davidson,M,16/05/1984,36,185198,124192,61006,Manager.Senior.Service Line,APJ Security Management
5803,Colin Calhoun,M,25/02/1982,38,188745,120638,68107,Manager.Senior.Engineering,Enterprise Applications
4388,Claudio Esparza,M,1/10/84,35,186004,102457,83547,Manager..Technical Support,AmaTec - Mgmt
22922,Liza Raymond,F,27/08/1993,26,186636,155689,30947,Software Engineer.Senior.,Media Portal
14428,Rosetta Lyons,F,12/11/82,37,188498,103788,84710,Manager.Senior.Learning & Development,International - Learning & Dev
15342,Quentin Holmes,M,4/7/89,31,186645,154791,31854,Solutions Architect.Senior.,APJ Security Services
10837,Roberto Mosley,M,4/8/82,37,188649,98353,90296,Manager..Engineering,Media Services Engineering
11298,Erich Carroll,M,18/01/1989,31,191473,103972,87501,Security Operations Center Specialist.Senior II Lead.,APJ Security Services - SOCC
17136,Houston Montes,M,6/2/73,47,192480,132764,59716,Manager.Senior.Systems Administration,Enterprise Infrastructure Services
10007,Whitney Pham,M,26/07/1981,38,191827,106486,85341,Manager.Senior.Software Development Engineer in Test,Media Experience SQA
4580,Foster Durham,M,13/08/1983,36,189763,97727,92036,Architect.Senior.,Media Experience Product Architecture
8823,Diann Fox,F,18/05/1987,33,191157,120428,70729,Manager.Senior.Engineering,Enterprise Applications
5134,Williams Kaiser,M,12/7/80,40,193746,123915,69831,Manager..Technical Support,AmaTec - Mgmt
5102,Joesph Valencia,M,2/11/86,33,195161,133524,61637,Practice Manager.Senior.,GSS Service Delivery Mgmt
8995,Thad Velasquez,M,17/05/1982,38,192437,101600,90837,Manager..Engineering,Media Delivery Product Engineering
4807,Jc Chang,M,1/4/80,40,194756,92593,102163,Software Engineer.Principal.,Security Engineering
2823,Stephan Benjamin,M,2/11/75,44,195326,101530,93796,Manager.Senior.Platform Operations,GPO PMO & Business Operations
10290,Emmitt Blankenship,M,6/10/80,39,196822,96836,99986,Manager..Program Management Technical,Program Management
15490,Wade Phelps,M,17/03/1985,35,195334,99889,95445,Manager..Engineering,Media Ghost
19958,Reinaldo Dyer,M,10/4/83,37,197379,106611,90768,Product Manager.Senior.,Luna/Open Product
8182,Leon Peck,M,8/3/84,36,197236,137697,59539,Product Manager.Senior.,Security Product
4748,Theron Dunlap,M,30/06/1980,40,198915,138450,60465,Manager.Senior.Technical Support,AmaTec - Mgmt
5238,Elton Holmes,M,23/02/1978,42,196719,93982,102737,Director..Accounting,Finance - Accounting
9360,Marion Hartman,M,7/4/84,36,202251,103913,98338,Software Engineer.Principal.,Media Services Engineering
15636,Deandre Valdez,M,12/11/78,41,202977,137789,65188,Architect.Senior.,Developer Productivity
19207,Steve Cuevas,M,8/6/80,40,201862,104136,97726,Software Engineer.Principal.,Media Portal
3361,Cedric Archer,M,18/09/1975,44,206532,138205,68327,Manager.Senior.Network Service Management,Networks - APJ Infrastructure
18462,Federico Wall,M,4/1/82,38,205242,172784,32458,Q/A Engineer.Principal.,Enterprise Access Engineering
16628,Norberto Mercer,M,22/11/1983,36,204993,96899,108094,Manager.Senior.Engineering,Corporate Systems
5606,Johanna Bray,F,10/9/83,36,206298,136657,69641,Manager..Engineering,Security Engineering
18668,Tyler Collins,M,19/09/1975,44,209991,96848,113143,Manager.Senior.Software Development Engineer in Test,Media Analytics
4270,Isaiah Wyatt,M,17/01/1983,37,213566,109331,104235,Manager.Senior.Engineering,Enterprise Applications
4463,Walker Randolph,M,25/02/1980,40,214619,109816,104803,Manager.Senior.Engineering,AmaTec - APS
22986,Luther Glenn,M,21/10/1990,29,215370,209000,6370,Technical Project Manager II..,APJ Security Services
5756,Darrin Boyle,M,10/8/81,38,215004,103897,111107,Manager..Engineering,Media Portal
5835,Derrick Navarro,M,9/12/78,41,217375,109835,107540,Practice Manager.Senior.,APJ Security Services - SOCC
2810,Kristine Werner,F,30/06/1978,42,220680,107845,112835,Director..Program Management,Wizards Program
22033,Carl Crawford,M,11/5/81,39,221797,145274,76523,Enterprise Security Architect.Senior II.,APJ Security Sales
19113,Stefan Wiggins,M,23/08/1973,46,223132,101930,121202,Software Engineer.Principal.,Enterprise Networks
20648,Orville Mccoy,M,4/4/84,36,226580,114054,112526,Relationship Manager.Senior.,Web Americas Inside Sales East
4907,Maggie Malone,F,16/09/1974,45,229359,109990,119369,Program Manager.Principal.Technical,CIO Management
4421,Jean Pham,M,30/12/1975,44,226169,145708,80461,Director..Technical Support,AmaTec - Mgmt
18221,Hans King,M,17/07/1975,44,230323,153566,76757,Manager.Senior.Engineering,Web Performance Engineering
22950,Clyde Franklin,M,12/1/91,29,228195,220856,7339,Software Engineer II..,Platform Mapping Engineering
22804,Harland Murray,M,2/6/82,38,227813,150318,77495,Manager.Senior.Engineering,GSS EPIC Engineering (HC COGS)
20635,Norbert Schneider,M,6/2/78,42,232358,148868,83490,Enterprise Sales Executive.Principal.New and Existing Accts,APJ Enterprise Sales
16711,Ian Bolton,M,1/4/81,39,234492,121302,113190,Architect.Senior Lead.,Enterprise Access Engineering
4069,Kieth Fleming,M,10/5/80,40,232149,120221,111928,Manager.Senior.Engineering,Security Engineering
8113,Zackary Mcpherson,M,27/09/1973,46,233773,106725,127048,Director..Account Management,APJ - AMG
14723,Wendell Benson,M,24/05/1978,42,232627,152618,80009,Manager.Senior.Engineering,Enterprise Security
7772,Sid Baxter,M,11/5/83,37,235883,160397,75486,Manager.Senior.Engineering,Corporate Systems
7260,Garland Gonzales,M,17/05/1973,47,237718,37757,199961,Manager.Senior.Compensation and Benefits,International - Comp & Ben
9331,Andre Malone,M,26/06/1978,42,238555,109967,128588,Software Engineer.Principal.,Enterprise Networks
4842,Rupert Zimmerman,M,2/12/84,35,245627,96116,149511,Manager.Senior.Engineering,Media Ghost
20349,Eldridge Howard,M,1/4/79,41,244298,105911,138387,Software Engineer.Principal.,Enterprise Access Engineering
12151,Rob Barajas,M,11/7/79,41,242645,135350,107295,Manager.Senior.Technical Support,AmaTec - Mgmt
4961,Erick Oconnor,M,25/06/1982,38,246699,169263,77436,Manager.Senior.Engineering,Platform Mapping Engineering
11945,Carter Waller,M,24/07/1977,42,247458,113828,133630,Manager.Senior.Engineering,Media Portal
20701,Timmy Figueroa,M,21/05/1982,38,249254,96543,152711,Product Manager.Senior.,Technology Research and Evangelism
17732,Rhett Marshall,M,14/04/1981,39,251367,131645,119722,Director..Technical Support,AmaTec - Mgmt
8694,Jermaine Waller,M,12/8/76,43,250759,112732,138027,Director..Platform Operations,Product - Custom
5433,Gino Orr,M,21/06/1977,43,252849,151893,100956,Director..Customer Financial Operations,Finance - Customer Revenue Operations G&A
2824,Milo Tapia,M,21/10/1979,40,253962,119010,134952,Manager.Senior.Engineering,Media Analytics
18976,Hope Webb,F,6/3/78,42,254557,157616,96941,Manager.Senior.Technical Enablement,Training - Sales Enablement
3273,Sammie Serrano,M,25/12/1982,37,253863,107419,146444,Manager.Senior.Performance Engineering,Product - Custom
6549,Quentin Stevenson,M,19/03/1978,42,255086,129205,125881,Manager.Senior.Technical Support,AmaTec - Mgmt
9333,Elroy Wu,M,12/12/77,42,262364,127187,135177,Software Engineer.Principal Lead.,Enterprise Networks
4677,Donte Wade,M,2/1/82,38,263109,110691,152418,Relationship Manager.Senior.,Media AMER Sales ECG
11255,Felton Hunt,M,28/04/1965,55,262518,123141,139377,Architect.Principal Lead.,Media Analytics
8592,Micah Dunlap,M,2/11/83,36,265427,135279,130148,Software Engineer.Principal Lead.,Enterprise Applications
3936,Jame Cobb,M,15/04/1971,49,264455,116727,147728,Director..Engineering,Enterprise Applications
17415,Len Bennett,M,15/10/1976,43,274366,117241,157125,Software Engineer.Principal.,Enterprise Access Engineering
11499,Patricia Harding,M,13/07/1977,43,283143,129370,153773,Director..Product Operations,Service Delivery Excellence
9221,Ulysses Lin,M,22/07/1984,35,286423,140065,146358,Director..Service Line,APJ Security Services - SOCC
5989,Tracy Frederick,M,23/08/1979,40,287140,125096,162044,Director.Senior.Technical Support,AmaTec - Mgmt
11441,Parker Barajas,M,28/03/1964,56,315308,144746,170562,Director..Program Management Technical,Enterprise Applications
5960,Jamar Cummings,M,20/05/1975,45,313726,142823,170903,Director..Product Line,Media & Carrier Business Development
2840,Francesco Warren,M,11/10/75,44,324636,139627,185009,Strategic Sales Director..,APJ Enterprise Sales
8301,Tyrell Cross,M,24/09/1978,41,324311,200990,123321,Director..Finance,Media Division Finance
15660,Paris Lozano,M,30/08/1977,42,363534,222913,140621,Director..Engineering,Developer Productivity
3068,Arline Navarro,F,6/1/76,44,372533,137347,235186,Director..Engineering,LUNA/OPEN Engineering
5069,Johnie Mcdowell,M,9/11/66,53,377792,168190,209602,Director..Human Resources,International - Business Partners
5162,Alfredo Hodges,M,1/6/77,43,387270,218798,168472,Director.Senior.Engineering,IT DevOps
11865,Bert Fleming,M,11/7/72,48,389551,173074,216477,Director..Engineering,Media Analytics
4039,Brady Calhoun,M,16/04/1984,36,452327,282991,169336,Manager.Senior.ECG,Web Americas Field West
10786,Alejandro Cantrell,M,4/6/84,36,476544,322086,154458,Relationship Manager.Senior.,Web Americas Inside Sales East
3041,Edmundo Navarro,M,3/1/74,46,477957,51590,426367,Vice President..Platform Delivery,Networks - Planning
16706,Nestor Parsons,M,11/12/69,50,490942,215023,275919,Director..Engineering,Enterprise Access Engineering
4672,Alfred Hickman,M,20/09/1972,47,518455,237756,280699,Vice President & Managing Director India..,Enterprise Applications
